orderdetailid,orderid,itemid,PreparationTime,DeliveryTime,TotalTime
1,1,274,31,105,136
2,2,320,23,69,92
3,3,132,27,44,71
4,4,114,24,41,65
5,5,220,45,91,136
6,6,433,34,94,128
7,7,131,33,40,73
8,8,283,42,99,141
9,9,248,32,28,60
10,10,355,54,117,171
11,11,420,40,32,72
12,12,66,47,81,128
13,13,468,51,98,149
14,14,156,16,58,74
15,15,9,55,92,147
16,16,79,42,75,117
17,17,476,60,75,135
18,18,380,21,93,114
19,19,68,56,44,100
20,20,311,60,46,106
21,21,424,60,77,137
22,22,88,13,36,49
23,23,158,47,120,167
24,24,425,37,52,89
25,25,145,38,110,148
26,26,349,28,34,62
27,27,302,21,108,129
28,28,31,22,81,103
29,29,152,30,90,120
30,30,383,29,92,121
31,31,389,14,27,41
32,32,151,18,86,104
33,33,366,26,112,138
34,34,477,25,39,64
35,35,451,39,108,147
36,36,464,35,107,142
37,37,393,51,63,114
38,38,119,42,33,75
39,39,250,27,58,85
40,40,347,34,87,121
41,41,201,37,78,115
42,42,470,49,92,141
43,43,328,51,15,66
44,44,189,51,75,126
45,45,205,46,113,159
46,46,49,59,114,173
47,47,244,16,101,117
48,48,308,19,46,65
49,49,56,46,82,128
50,50,355,18,97,115
51,51,285,52,80,132
52,52,9,51,103,154
53,53,388,44,77,121
54,54,287,42,67,109
55,55,225,26,20,46
56,56,265,13,63,76
57,57,25,39,111,150
58,58,138,19,69,88
59,59,305,35,59,94
60,60,8,39,88,127
61,61,461,35,30,65
62,62,206,29,118,147
63,63,253,19,100,119
64,64,352,26,21,47
65,65,165,17,103,120
66,66,65,23,65,88
67,67,311,38,64,102
68,68,88,48,89,137
69,69,433,33,87,120
70,70,300,16,77,93
71,71,415,41,119,160
72,72,261,49,25,74
73,73,468,49,120,169
74,74,66,20,39,59
75,75,397,29,27,56
76,76,291,53,67,120
77,77,386,26,35,61
78,78,440,32,77,109
79,79,390,13,42,55
80,80,243,40,69,109
81,81,51,13,48,61
82,82,26,60,63,123
83,83,82,14,100,114
84,84,124,55,117,172
85,85,377,23,55,78
86,86,392,55,66,121
87,87,236,14,114,128
88,88,55,53,114,167
89,89,365,41,48,89
90,90,233,60,115,175
91,91,228,13,76,89
92,92,121,50,42,92
93,93,129,56,58,114
94,94,284,55,117,172
95,95,192,39,44,83
96,96,130,57,17,74
97,97,60,41,58,99
98,98,311,29,37,66
99,99,171,60,107,167
100,100,367,41,80,121
101,101,18,37,35,72
102,102,314,47,82,129
103,103,474,29,87,116
104,104,90,12,43,55
105,105,422,28,78,106
106,106,63,48,41,89
107,107,249,31,89,120
108,108,401,27,110,137
109,109,202,10,55,65
110,110,474,42,107,149
111,111,254,24,90,114
112,112,169,47,33,80
113,113,41,52,62,114
114,114,456,43,34,77
115,115,409,30,21,51
116,116,321,26,66,92
117,117,307,23,100,123
118,118,388,31,34,65
119,119,348,37,22,59
120,120,479,48,114,162
121,121,453,24,47,71
122,122,189,56,43,99
123,123,272,13,71,84
124,124,323,10,28,38
125,125,145,23,118,141
126,126,192,38,58,96
127,127,270,13,79,92
128,128,80,57,15,72
129,129,413,27,33,60
130,130,71,18,24,42
131,131,43,17,112,129
132,132,4,51,32,83
133,133,339,49,97,146
134,134,222,47,90,137
135,135,396,20,49,69
136,136,20,55,71,126
137,137,308,51,48,99
138,138,244,31,95,126
139,139,138,10,56,66
140,140,19,57,115,172
141,141,111,30,108,138
142,142,360,24,93,117
143,143,264,32,77,109
144,144,394,45,69,114
145,145,100,35,72,107
146,146,141,21,37,58
147,147,468,25,59,84
148,148,44,39,18,57
149,149,150,50,119,169
150,150,39,23,65,88
151,151,114,33,40,73
152,152,185,21,57,78
153,153,387,48,105,153
154,154,290,25,91,116
155,155,140,15,88,103
156,156,266,16,24,40
157,157,153,29,43,72
158,158,298,41,17,58
159,159,296,14,113,127
160,160,72,48,37,85
161,161,467,27,64,91
162,162,323,43,34,77
163,163,188,38,62,100
164,164,356,33,64,97
165,165,402,13,66,79
166,166,213,12,45,57
167,167,443,17,47,64
168,168,160,47,54,101
169,169,263,57,39,96
170,170,477,53,72,125
171,171,248,32,91,123
172,172,129,60,87,147
173,173,223,41,102,143
174,174,474,35,105,140
175,175,131,21,61,82
176,176,230,31,44,75
177,177,59,33,79,112
178,178,204,57,64,121
179,179,137,38,65,103
180,180,231,34,107,141
181,181,120,54,43,97
182,182,367,53,98,151
183,183,328,27,35,62
184,184,84,14,65,79
185,185,25,32,45,77
186,186,404,15,48,63
187,187,469,60,50,110
188,188,391,21,115,136
189,189,75,31,84,115
190,190,248,26,21,47
191,191,257,20,17,37
192,192,317,28,24,52
193,193,96,42,20,62
194,194,164,16,62,78
195,195,330,36,74,110
196,196,240,51,53,104
197,197,459,14,15,29
198,198,262,51,21,72
199,199,396,20,40,60
200,200,210,59,66,125
201,201,114,39,71,110
202,202,266,43,61,104
203,203,67,49,71,120
204,204,414,36,67,103
205,205,473,53,76,129
206,206,125,41,24,65
207,207,365,12,111,123
208,208,390,20,119,139
209,209,195,39,94,133
210,210,430,39,96,135
211,211,330,27,20,47
212,212,290,31,115,146
213,213,314,60,42,102
214,214,443,23,21,44
215,215,252,49,87,136
216,216,352,17,54,71
217,217,431,28,91,119
218,218,200,24,81,105
219,219,184,25,67,92
220,220,311,52,18,70
221,221,172,25,111,136
222,222,407,12,119,131
223,223,126,16,30,46
224,224,359,43,42,85
225,225,341,38,21,59
226,226,273,18,37,55
227,227,53,37,82,119
228,228,142,28,33,61
229,229,209,58,37,95
230,230,4,17,96,113
231,231,467,18,99,117
232,232,258,42,110,152
233,233,364,33,32,65
234,234,195,11,74,85
235,235,286,49,68,117
236,236,126,34,82,116
237,237,401,26,55,81
238,238,448,22,103,125
239,239,265,56,46,102
240,240,228,47,88,135
241,241,156,25,15,40
242,242,334,60,45,105
243,243,336,54,83,137
244,244,369,50,53,103
245,245,254,29,49,78
246,246,65,26,86,112
247,247,2,60,61,121
248,248,465,58,58,116
249,249,467,20,116,136
250,250,36,19,44,63
251,251,118,44,63,107
252,252,42,37,44,81
253,253,39,29,60,89
254,254,454,48,53,101
255,255,382,18,43,61
256,256,136,42,91,133
257,257,46,48,45,93
258,258,113,10,69,79
259,259,324,54,31,85
260,260,141,15,36,51
261,261,317,31,82,113
262,262,415,33,65,98
263,263,420,26,55,81
264,264,61,14,113,127
265,265,147,60,20,80
266,266,346,25,45,70
267,267,223,39,109,148
268,268,430,36,80,116
269,269,43,20,97,117
270,270,72,15,119,134
271,271,417,47,116,163
272,272,338,18,56,74
273,273,310,10,118,128
274,274,440,44,118,162
275,275,50,33,16,49
276,276,304,35,112,147
277,277,171,29,112,141
278,278,206,33,115,148
279,279,445,40,65,105
280,280,471,28,103,131
281,281,63,16,36,52
282,282,68,33,83,116
283,283,142,45,104,149
284,284,118,40,31,71
285,285,166,58,49,107
286,286,38,14,68,82
287,287,471,21,58,79
288,288,365,24,98,122
289,289,82,17,77,94
290,290,403,50,64,114
291,291,104,44,77,121
292,292,262,24,59,83
293,293,81,14,73,87
294,294,283,57,76,133
295,295,19,53,35,88
296,296,274,49,70,119
297,297,270,20,76,96
298,298,16,51,120,171
299,299,215,33,100,133
300,300,34,29,65,94
301,301,429,33,118,151
302,302,134,30,68,98
303,303,287,29,114,143
304,304,10,16,25,41
305,305,5,15,33,48
306,306,279,20,43,63
307,307,357,44,15,59
308,308,158,45,102,147
309,309,259,19,95,114
310,310,15,17,115,132
311,311,113,59,45,104
312,312,400,28,20,48
313,313,85,20,20,40
314,314,413,53,100,153
315,315,261,60,92,152
316,316,314,42,101,143
317,317,40,24,83,107
318,318,61,30,94,124
319,319,168,37,56,93
320,320,403,18,67,85
321,321,420,34,36,70
322,322,361,32,94,126
323,323,358,37,95,132
324,324,245,22,92,114
325,325,426,15,57,72
326,326,451,44,81,125
327,327,90,21,81,102
328,328,394,59,105,164
329,329,155,51,32,83
330,330,435,28,18,46
331,331,366,14,100,114
332,332,184,27,26,53
333,333,331,18,47,65
334,334,206,33,73,106
335,335,425,54,45,99
336,336,30,49,112,161
337,337,208,18,92,110
338,338,394,50,68,118
339,339,466,21,22,43
340,340,381,49,98,147
341,341,377,40,91,131
342,342,183,10,29,39
343,343,440,36,32,68
344,344,406,60,29,89
345,345,420,34,95,129
346,346,420,25,31,56
347,347,301,46,119,165
348,348,315,32,106,138
349,349,249,23,64,87
350,350,244,59,38,97
351,351,34,25,116,141
352,352,183,51,48,99
353,353,395,18,59,77
354,354,447,40,111,151
355,355,304,13,111,124
356,356,146,59,72,131
357,357,312,40,83,123
358,358,414,16,53,69
359,359,328,20,20,40
360,360,301,56,96,152
361,361,355,19,93,112
362,362,287,33,46,79
363,363,467,15,96,111
364,364,370,26,74,100
365,365,443,18,45,63
366,366,374,52,21,73
367,367,235,16,32,48
368,368,184,13,85,98
369,369,215,24,66,90
370,370,302,21,29,50
371,371,61,21,42,63
372,372,22,58,15,73
373,373,88,14,64,78
374,374,392,28,50,78
375,375,311,20,71,91
376,376,341,13,100,113
377,377,303,39,63,102
378,378,347,37,79,116
379,379,141,11,49,60
380,380,296,16,73,89
381,381,181,24,88,112
382,382,234,14,113,127
383,383,358,57,15,72
384,384,51,32,102,134
385,385,178,29,38,67
386,386,126,49,69,118
387,387,121,27,76,103
388,388,291,47,70,117
389,389,94,47,90,137
390,390,448,44,26,70
391,391,301,27,116,143
392,392,329,37,51,88
393,393,8,48,83,131
394,394,131,13,27,40
395,395,24,10,93,103
396,396,27,55,50,105
397,397,2,49,31,80
398,398,213,59,78,137
399,399,307,54,105,159
400,400,47,48,36,84
401,401,162,15,75,90
402,402,420,53,114,167
403,403,196,58,29,87
404,404,350,32,73,105
405,405,290,24,70,94
406,406,172,35,100,135
407,407,166,59,109,168
408,408,434,21,50,71
409,409,219,49,69,118
410,410,47,10,22,32
411,411,415,28,93,121
412,412,384,52,90,142
413,413,385,39,91,130
414,414,434,52,94,146
415,415,327,38,77,115
416,416,450,18,75,93
417,417,391,54,115,169
418,418,173,54,69,123
419,419,313,58,108,166
420,420,270,22,113,135
421,421,397,33,27,60
422,422,32,33,37,70
423,423,144,22,75,97
424,424,48,23,72,95
425,425,292,50,85,135
426,426,163,25,22,47
427,427,143,14,16,30
428,428,376,29,93,122
429,429,419,56,85,141
430,430,316,20,29,49
431,431,9,53,28,81
432,432,322,51,51,102
433,433,455,27,76,103
434,434,330,30,40,70
435,435,13,40,40,80
436,436,294,47,109,156
437,437,8,54,72,126
438,438,116,49,82,131
439,439,158,52,79,131
440,440,469,56,111,167
441,441,375,40,79,119
442,442,383,30,99,129
443,443,298,54,55,109
444,444,45,56,99,155
445,445,227,41,117,158
446,446,349,17,34,51
447,447,158,24,33,57
448,448,386,33,69,102
449,449,229,56,30,86
450,450,91,18,107,125
451,451,237,51,64,115
452,452,95,42,82,124
453,453,344,42,50,92
454,454,292,30,40,70
455,455,300,46,27,73
456,456,456,33,97,130
457,457,230,14,35,49
458,458,197,33,101,134
459,459,46,37,45,82
460,460,157,50,81,131
461,461,478,38,17,55
462,462,454,18,48,66
463,463,154,51,65,116
464,464,360,12,102,114
465,465,165,55,15,70
466,466,114,19,31,50
467,467,161,40,69,109
468,468,117,25,22,47
469,469,1,50,93,143
470,470,309,54,67,121
471,471,269,46,17,63
472,472,53,36,16,52
473,473,286,31,23,54
474,474,52,23,16,39
475,475,178,60,87,147
476,476,412,53,120,173
477,477,479,38,19,57
478,478,481,43,65,108
479,479,166,49,79,128
480,480,143,38,36,74
481,481,372,30,77,107
482,482,72,46,47,93
483,483,58,42,99,141
484,484,194,36,84,120
485,485,474,47,15,62
486,486,46,39,29,68
487,487,462,49,64,113
488,488,367,25,34,59
489,489,227,29,89,118
490,490,252,14,88,102
491,491,314,37,99,136
492,492,192,49,64,113
493,493,367,13,114,127
494,494,21,19,79,98
495,495,89,40,15,55
496,496,100,23,95,118
497,497,481,11,36,47
498,498,92,42,59,101
499,499,364,29,85,114
500,500,153,58,112,170
501,501,263,42,76,118
502,502,450,11,41,52
503,503,298,29,97,126
504,504,89,33,76,109
505,505,199,40,116,156
506,506,355,21,51,72
507,507,302,24,47,71
508,508,413,25,43,68
509,509,299,31,85,116
510,510,239,58,34,92
511,511,441,22,77,99
512,512,117,41,70,111
513,513,86,12,35,47
514,514,415,23,68,91
515,515,334,20,102,122
516,516,211,41,99,140
517,517,162,55,60,115
518,518,12,50,37,87
519,519,289,31,70,101
520,520,311,28,71,99
521,521,343,45,91,136
522,522,362,52,75,127
523,523,177,18,66,84
524,524,194,23,15,38
525,525,99,36,79,115
526,526,71,25,92,117
527,527,281,35,70,105
528,528,477,52,53,105
529,529,192,23,53,76
530,530,332,40,102,142
531,531,469,52,59,111
532,532,268,45,115,160
533,533,279,40,103,143
534,534,15,18,97,115
535,535,232,29,28,57
536,536,481,59,42,101
537,537,452,50,71,121
538,538,151,32,64,96
539,539,230,58,92,150
540,540,255,14,70,84
541,541,144,47,66,113
542,542,337,21,90,111
543,543,256,58,53,111
544,544,253,18,33,51
545,545,470,31,86,117
546,546,422,12,92,104
547,547,15,25,34,59
548,548,371,37,109,146
549,549,127,34,78,112
550,550,24,12,51,63
551,551,112,32,110,142
552,552,452,41,119,160
553,553,61,49,40,89
554,554,37,58,39,97
555,555,348,17,46,63
556,556,377,48,119,167
557,557,161,27,27,54
558,558,80,19,64,83
559,559,323,31,117,148
560,560,345,53,55,108
561,561,84,23,27,50
562,562,248,32,93,125
563,563,32,51,92,143
564,564,159,20,95,115
565,565,288,18,28,46
566,566,468,41,94,135
567,567,283,49,28,77
568,568,324,13,88,101
569,569,262,59,25,84
570,570,270,21,37,58
571,571,75,53,34,87
572,572,87,42,65,107
573,573,304,17,85,102
574,574,234,55,99,154
575,575,31,53,109,162
576,576,441,20,29,49
577,577,68,52,37,89
578,578,63,22,89,111
579,579,179,15,88,103
580,580,161,52,120,172
581,581,198,57,22,79
582,582,410,50,58,108
583,583,342,59,81,140
584,584,374,11,106,117
585,585,208,59,98,157
586,586,233,44,51,95
587,587,357,27,99,126
588,588,391,54,94,148
589,589,471,26,90,116
590,590,2,22,103,125
591,591,275,22,30,52
592,592,85,56,15,71
593,593,216,38,64,102
594,594,211,42,85,127
595,595,306,12,47,59
596,596,466,38,29,67
597,597,50,13,89,102
598,598,183,42,71,113
599,599,51,38,109,147
600,600,284,39,87,126
601,601,195,54,114,168
602,602,384,57,118,175
603,603,156,56,61,117
604,604,293,41,20,61
605,605,260,13,29,42
606,606,350,15,44,59
607,607,418,27,113,140
608,608,200,55,47,102
609,609,391,29,80,109
610,610,401,51,94,145
611,611,110,42,52,94
612,612,164,60,38,98
613,613,316,55,53,108
614,614,176,51,95,146
615,615,129,35,54,89
616,616,167,40,113,153
617,617,377,10,45,55
618,618,4,60,39,99
619,619,155,29,20,49
620,620,214,43,115,158
621,621,226,33,109,142
622,622,284,27,22,49
623,623,352,37,27,64
624,624,321,40,108,148
625,625,409,56,78,134
626,626,388,58,89,147
627,627,47,34,18,52
628,628,137,48,107,155
629,629,451,51,48,99
630,630,293,42,111,153
631,631,226,34,55,89
632,632,176,42,89,131
633,633,434,16,67,83
634,634,274,42,67,109
635,635,356,56,116,172
636,636,376,18,24,42
637,637,209,21,39,60
638,638,338,18,57,75
639,639,35,22,106,128
640,640,321,10,64,74
641,641,238,12,111,123
642,642,417,60,108,168
643,643,140,31,83,114
644,644,481,56,82,138
645,645,53,30,111,141
646,646,256,11,110,121
647,647,337,44,94,138
648,648,151,47,58,105
649,649,58,13,29,42
650,650,225,12,28,40
651,651,439,41,70,111
652,652,31,56,114,170
653,653,68,11,94,105
654,654,334,14,27,41
655,655,341,42,25,67
656,656,456,38,34,72
657,657,1,51,111,162
658,658,402,11,74,85
659,659,431,30,110,140
660,660,467,11,73,84
661,661,366,48,64,112
662,662,368,27,29,56
663,663,337,29,24,53
664,664,77,10,26,36
665,665,404,40,114,154
666,666,31,52,80,132
667,667,223,14,87,101
668,668,376,37,94,131
669,669,108,24,21,45
670,670,291,27,48,75
671,671,427,20,67,87
672,672,259,33,77,110
673,673,131,10,17,27
674,674,338,34,81,115
675,675,190,26,116,142
676,676,457,30,47,77
677,677,404,15,119,134
678,678,77,43,115,158
679,679,268,27,76,103
680,680,310,21,106,127
681,681,52,28,40,68
682,682,374,55,20,75
683,683,268,15,68,83
684,684,444,11,67,78
685,685,228,22,69,91
686,686,307,31,79,110
687,687,261,23,44,67
688,688,187,20,80,100
689,689,293,24,56,80
690,690,373,17,34,51
691,691,34,13,94,107
692,692,107,55,77,132
693,693,119,35,79,114
694,694,241,15,32,47
695,695,119,19,22,41
696,696,454,55,46,101
697,697,170,43,106,149
698,698,55,50,77,127
699,699,229,46,96,142
700,700,26,52,96,148
701,701,239,29,88,117
702,702,68,47,28,75
703,703,396,51,15,66
704,704,168,11,75,86
705,705,216,28,26,54
706,706,387,19,57,76
707,707,48,49,118,167
708,708,261,19,23,42
709,709,374,60,17,77
710,710,350,31,16,47
711,711,395,21,117,138
712,712,324,58,16,74
713,713,1,15,36,51
714,714,132,56,31,87
715,715,78,16,51,67
716,716,442,16,34,50
717,717,320,44,60,104
718,718,46,19,18,37
719,719,5,17,90,107
720,720,166,41,30,71
721,721,399,50,93,143
722,722,225,53,86,139
723,723,166,26,35,61
724,724,272,20,76,96
725,725,126,21,18,39
726,726,299,23,117,140
727,727,183,31,92,123
728,728,167,60,56,116
729,729,266,16,54,70
730,730,238,16,66,82
731,731,153,17,33,50
732,732,360,23,40,63
733,733,474,48,31,79
734,734,212,19,118,137
735,735,371,41,47,88
736,736,220,26,80,106
737,737,378,34,72,106
738,738,133,55,55,110
739,739,320,37,16,53
740,740,235,19,112,131
741,741,218,29,21,50
742,742,26,32,34,66
743,743,345,31,47,78
744,744,54,37,43,80
745,745,327,52,60,112
746,746,286,12,75,87
747,747,52,43,88,131
748,748,90,39,29,68
749,749,350,13,64,77
750,750,472,53,44,97
751,751,195,22,79,101
752,752,300,42,56,98
753,753,416,18,78,96
754,754,313,35,41,76
755,755,390,11,61,72
756,756,374,30,109,139
757,757,407,46,73,119
758,758,429,13,88,101
759,759,185,57,81,138
760,760,361,22,38,60
761,761,92,21,79,100
762,762,322,31,105,136
763,763,338,37,31,68
764,764,394,16,115,131
765,765,185,33,51,84
766,766,246,57,72,129
767,767,303,12,37,49
768,768,380,47,18,65
769,769,97,20,25,45
770,770,101,48,28,76
771,771,270,36,118,154
772,772,249,29,67,96
773,773,392,20,28,48
774,774,356,59,40,99
775,775,366,49,20,69
776,776,433,11,106,117
777,777,337,37,58,95
778,778,206,48,88,136
779,779,111,48,30,78
780,780,253,36,18,54
781,781,107,44,44,88
782,782,320,50,57,107
783,783,184,12,31,43
784,784,415,12,35,47
785,785,310,22,63,85
786,786,379,20,51,71
787,787,25,49,85,134
788,788,349,33,63,96
789,789,123,14,48,62
790,790,455,38,45,83
791,791,271,18,42,60
792,792,475,57,37,94
793,793,250,18,67,85
794,794,363,34,65,99
795,795,325,14,20,34
796,796,466,54,108,162
797,797,472,38,22,60
798,798,128,21,77,98
799,799,152,50,108,158
800,800,70,12,105,117
801,801,245,58,70,128
802,802,27,23,51,74
803,803,428,42,42,84
804,804,292,12,57,69
805,805,243,43,98,141
806,806,391,27,112,139
807,807,149,24,39,63
808,808,262,47,63,110
809,809,307,39,92,131
810,810,23,55,53,108
811,811,462,25,47,72
812,812,381,17,20,37
813,813,293,13,59,72
814,814,44,15,50,65
815,815,99,21,60,81
816,816,56,16,30,46
817,817,136,36,53,89
818,818,106,55,56,111
819,819,450,52,64,116
820,820,15,37,60,97
821,821,358,48,117,165
822,822,179,50,94,144
823,823,173,29,25,54
824,824,173,17,41,58
825,825,109,30,79,109
826,826,233,47,112,159
827,827,406,19,32,51
828,828,312,20,100,120
829,829,95,14,61,75
830,830,125,17,18,35
831,831,266,39,54,93
832,832,475,50,36,86
833,833,329,21,38,59
834,834,218,37,59,96
835,835,222,20,62,82
836,836,57,12,83,95
837,837,259,24,89,113
838,838,336,56,20,76
839,839,88,31,61,92
840,840,241,53,116,169
841,841,206,32,17,49
842,842,406,28,48,76
843,843,219,44,28,72
844,844,177,27,44,71
845,845,60,49,19,68
846,846,392,40,43,83
847,847,229,41,54,95
848,848,104,32,66,98
849,849,457,37,18,55
850,850,209,49,23,72
851,851,426,15,107,122
852,852,123,28,107,135
853,853,56,20,118,138
854,854,366,52,119,171
855,855,132,36,61,97
856,856,178,36,90,126
857,857,412,58,73,131
858,858,376,41,32,73
859,859,413,35,95,130
860,860,134,42,120,162
861,861,392,42,72,114
862,862,129,17,106,123
863,863,45,55,58,113
864,864,63,37,111,148
865,865,83,57,101,158
866,866,249,23,25,48
867,867,213,56,64,120
868,868,144,20,64,84
869,869,238,42,56,98
870,870,75,52,28,80
871,871,316,13,80,93
872,872,325,39,26,65
873,873,222,56,75,131
874,874,447,35,94,129
875,875,102,31,37,68
876,876,412,26,38,64
877,877,198,33,101,134
878,878,9,49,32,81
879,879,2,24,48,72
880,880,451,20,97,117
881,881,280,37,89,126
882,882,265,58,113,171
883,883,139,41,28,69
884,884,445,51,87,138
885,885,219,47,60,107
886,886,116,35,32,67
887,887,413,58,102,160
888,888,47,52,42,94
889,889,346,60,109,169
890,890,333,30,113,143
891,891,462,31,15,46
892,892,199,50,117,167
893,893,434,27,110,137
894,894,224,17,62,79
895,895,39,47,77,124
896,896,408,36,21,57
897,897,56,27,60,87
898,898,359,12,60,72
899,899,136,24,92,116
900,900,241,15,105,120
901,901,220,15,58,73
902,902,139,31,120,151
903,903,93,31,98,129
904,904,398,59,56,115
905,905,346,35,118,153
906,906,96,41,62,103
907,907,397,25,118,143
908,908,81,42,97,139
909,909,205,18,100,118
910,910,242,28,38,66
911,911,289,31,106,137
912,912,150,26,58,84
913,913,174,49,27,76
914,914,470,55,108,163
915,915,82,51,38,89
916,916,99,47,101,148
917,917,165,20,74,94
918,918,390,26,92,118
919,919,444,45,28,73
920,920,105,24,83,107
921,921,33,21,47,68
922,922,408,46,49,95
923,923,297,54,111,165
924,924,316,50,86,136
925,925,50,35,88,123
926,926,446,39,94,133
927,927,139,27,79,106
928,928,171,24,102,126
929,929,458,28,58,86
930,930,21,55,56,111
931,931,398,50,117,167
932,932,43,22,78,100
933,933,364,21,24,45
934,934,70,41,93,134
935,935,97,53,69,122
936,936,198,60,55,115
937,937,61,42,42,84
938,938,30,30,69,99
939,939,227,41,22,63
940,940,163,28,107,135
941,941,443,57,99,156
942,942,71,31,84,115
943,943,76,33,70,103
944,944,19,51,18,69
945,945,2,20,34,54
946,946,200,52,119,171
947,947,452,42,86,128
948,948,137,22,46,68
949,949,140,39,19,58
950,950,282,21,80,101
951,951,335,45,51,96
952,952,156,43,87,130
953,953,2,16,28,44
954,954,27,20,89,109
955,955,105,48,94,142
956,956,41,42,84,126
957,957,152,12,52,64
958,958,87,47,40,87
959,959,129,19,30,49
960,960,272,60,49,109
961,961,344,53,54,107
962,962,14,24,29,53
963,963,154,50,58,108
964,964,261,49,27,76
965,965,446,56,117,173
966,966,109,13,38,51
967,967,214,51,32,83
968,968,105,60,107,167
969,969,470,42,54,96
970,970,259,40,43,83
971,971,10,54,93,147
972,972,144,10,31,41
973,973,11,36,72,108
974,974,403,43,115,158
975,975,367,44,66,110
976,976,319,18,119,137
977,977,156,40,65,105
978,978,286,30,36,66
979,979,379,44,55,99
980,980,198,24,97,121
981,981,197,27,80,107
982,982,351,15,108,123
983,983,319,23,120,143
984,984,321,14,119,133
985,985,193,58,90,148
986,986,5,15,81,96
987,987,18,11,108,119
988,988,346,53,39,92
989,989,27,37,16,53
990,990,174,11,118,129
991,991,463,26,50,76
992,992,241,34,40,74
993,993,343,26,103,129
994,994,395,54,86,140
995,995,434,11,109,120
996,996,339,51,21,72
997,997,177,19,27,46
998,998,342,24,64,88
999,999,75,15,42,57
1000,1000,24,12,46,58
1001,1001,302,10,25,35
1002,1002,292,57,75,132
1003,1003,29,26,102,128
1004,1004,156,13,116,129
1005,1005,275,53,45,98
1006,1006,465,42,88,130
1007,1007,137,56,40,96
1008,1008,314,25,105,130
1009,1009,120,47,44,91
1010,1010,258,46,42,88
1011,1011,440,48,30,78
1012,1012,52,60,36,96
1013,1013,410,11,112,123
1014,1014,181,10,65,75
1015,1015,343,42,24,66
1016,1016,434,18,85,103
1017,1017,62,32,120,152
1018,1018,156,53,56,109
1019,1019,148,47,52,99
1020,1020,246,20,107,127
1021,1021,340,43,89,132
1022,1022,427,13,117,130
1023,1023,316,22,15,37
1024,1024,75,55,52,107
1025,1025,343,41,54,95
1026,1026,2,54,110,164
1027,1027,268,50,65,115
1028,1028,51,29,47,76
1029,1029,86,47,119,166
1030,1030,413,41,99,140
1031,1031,127,21,18,39
1032,1032,199,37,64,101
1033,1033,46,10,70,80
1034,1034,35,44,35,79
1035,1035,113,25,107,132
1036,1036,63,21,46,67
1037,1037,160,40,19,59
1038,1038,168,25,39,64
1039,1039,123,32,54,86
1040,1040,307,49,58,107
1041,1041,130,43,106,149
1042,1042,351,32,16,48
1043,1043,112,28,35,63
1044,1044,168,13,72,85
1045,1045,107,10,44,54
1046,1046,130,28,53,81
1047,1047,38,58,109,167
1048,1048,48,14,104,118
1049,1049,221,26,17,43
1050,1050,394,10,78,88
1051,1051,272,13,46,59
1052,1052,87,54,92,146
1053,1053,52,35,72,107
1054,1054,343,42,54,96
1055,1055,58,19,84,103
1056,1056,319,22,33,55
1057,1057,252,53,79,132
1058,1058,253,54,118,172
1059,1059,372,56,120,176
1060,1060,469,31,31,62
1061,1061,314,40,36,76
1062,1062,425,28,56,84
1063,1063,67,46,17,63
1064,1064,222,42,75,117
1065,1065,48,50,108,158
1066,1066,29,43,41,84
1067,1067,477,11,74,85
1068,1068,430,23,26,49
1069,1069,39,24,63,87
1070,1070,232,43,100,143
1071,1071,301,50,83,133
1072,1072,419,26,65,91
1073,1073,215,21,64,85
1074,1074,345,56,117,173
1075,1075,170,51,78,129
1076,1076,442,13,63,76
1077,1077,376,25,39,64
1078,1078,244,45,85,130
1079,1079,275,26,61,87
1080,1080,29,42,87,129
1081,1081,146,14,108,122
1082,1082,346,33,57,90
1083,1083,234,40,92,132
1084,1084,350,27,86,113
1085,1085,94,56,35,91
1086,1086,58,49,54,103
1087,1087,364,23,45,68
1088,1088,300,57,114,171
1089,1089,427,10,84,94
1090,1090,304,36,120,156
1091,1091,230,35,90,125
1092,1092,181,17,93,110
1093,1093,232,17,45,62
1094,1094,101,18,37,55
1095,1095,276,19,94,113
1096,1096,32,16,62,78
1097,1097,114,37,29,66
1098,1098,52,23,88,111
1099,1099,468,37,100,137
1100,1100,384,25,87,112
1101,1101,20,58,22,80
1102,1102,123,32,15,47
1103,1103,427,24,86,110
1104,1104,92,35,42,77
1105,1105,289,17,102,119
1106,1106,57,37,109,146
1107,1107,177,32,51,83
1108,1108,150,29,104,133
1109,1109,106,47,102,149
1110,1110,164,58,97,155
1111,1111,419,51,83,134
1112,1112,40,39,38,77
1113,1113,53,11,28,39
1114,1114,107,24,94,118
1115,1115,297,46,22,68
1116,1116,463,48,32,80
1117,1117,84,15,70,85
1118,1118,360,45,47,92
1119,1119,146,42,62,104
1120,1120,174,42,41,83
1121,1121,162,17,116,133
1122,1122,352,21,107,128
1123,1123,156,22,66,88
1124,1124,70,58,62,120
1125,1125,307,41,49,90
1126,1126,245,39,112,151
1127,1127,157,48,36,84
1128,1128,398,36,21,57
1129,1129,441,51,73,124
1130,1130,310,45,18,63
1131,1131,97,31,52,83
1132,1132,72,18,40,58
1133,1133,176,34,93,127
1134,1134,115,50,58,108
1135,1135,476,52,45,97
1136,1136,50,24,73,97
1137,1137,336,29,39,68
1138,1138,192,19,39,58
1139,1139,169,14,18,32
1140,1140,473,21,83,104
1141,1141,450,54,104,158
1142,1142,198,28,76,104
1143,1143,400,52,76,128
1144,1144,157,43,97,140
1145,1145,415,38,116,154
1146,1146,173,21,60,81
1147,1147,51,50,71,121
1148,1148,436,10,95,105
1149,1149,337,32,35,67
1150,1150,460,23,32,55
1151,1151,234,26,83,109
1152,1152,31,50,103,153
1153,1153,242,29,101,130
1154,1154,194,46,100,146
1155,1155,126,41,68,109
1156,1156,338,13,29,42
1157,1157,460,60,115,175
1158,1158,90,13,120,133
1159,1159,313,18,61,79
1160,1160,325,10,24,34
1161,1161,429,11,65,76
1162,1162,195,30,52,82
1163,1163,22,59,71,130
1164,1164,307,26,43,69
1165,1165,15,11,82,93
1166,1166,462,21,28,49
1167,1167,459,15,88,103
1168,1168,182,43,16,59
1169,1169,478,42,59,101
1170,1170,420,51,38,89
1171,1171,194,13,108,121
1172,1172,272,41,105,146
1173,1173,22,42,23,65
1174,1174,30,31,63,94
1175,1175,95,50,15,65
1176,1176,447,37,50,87
1177,1177,94,21,39,60
1178,1178,249,41,20,61
1179,1179,415,21,41,62
1180,1180,288,30,40,70
1181,1181,269,35,35,70
1182,1182,142,48,80,128
1183,1183,27,40,35,75
1184,1184,432,36,47,83
1185,1185,155,50,65,115
1186,1186,397,52,117,169
1187,1187,114,59,92,151
1188,1188,461,51,36,87
1189,1189,107,57,48,105
1190,1190,187,60,72,132
1191,1191,95,33,51,84
1192,1192,472,43,22,65
1193,1193,123,36,21,57
1194,1194,382,16,45,61
1195,1195,252,41,32,73
1196,1196,347,20,112,132
1197,1197,58,49,93,142
1198,1198,99,12,81,93
1199,1199,128,26,82,108
1200,1200,398,53,59,112
1201,1201,347,19,95,114
1202,1202,56,41,110,151
1203,1203,229,44,98,142
1204,1204,417,57,53,110
1205,1205,237,53,64,117
1206,1206,405,54,73,127
1207,1207,262,46,57,103
1208,1208,178,38,31,69
1209,1209,298,41,111,152
1210,1210,1,17,98,115
1211,1211,269,46,91,137
1212,1212,24,20,66,86
1213,1213,286,36,115,151
1214,1214,416,45,117,162
1215,1215,374,59,107,166
1216,1216,122,58,103,161
1217,1217,391,22,22,44
1218,1218,462,18,70,88
1219,1219,114,36,34,70
1220,1220,33,27,55,82
1221,1221,51,20,67,87
1222,1222,453,33,77,110
1223,1223,290,21,85,106
1224,1224,477,23,109,132
1225,1225,142,59,54,113
1226,1226,240,31,21,52
1227,1227,198,57,99,156
1228,1228,473,24,110,134
1229,1229,185,26,21,47
1230,1230,109,54,17,71
1231,1231,1,44,28,72
1232,1232,324,51,43,94
1233,1233,109,11,58,69
1234,1234,420,22,55,77
1235,1235,11,29,78,107
1236,1236,408,51,117,168
1237,1237,186,15,61,76
1238,1238,2,54,26,80
1239,1239,53,20,77,97
1240,1240,413,39,108,147
1241,1241,98,26,77,103
1242,1242,71,29,115,144
1243,1243,231,14,100,114
1244,1244,231,52,82,134
1245,1245,59,56,42,98
1246,1246,371,11,98,109
1247,1247,87,52,77,129
1248,1248,73,34,102,136
1249,1249,192,17,44,61
1250,1250,28,28,100,128
1251,1251,292,54,63,117
1252,1252,435,58,91,149
1253,1253,119,19,78,97
1254,1254,152,54,102,156
1255,1255,154,12,101,113
1256,1256,271,56,50,106
1257,1257,294,22,62,84
1258,1258,30,36,63,99
1259,1259,230,39,42,81
1260,1260,376,49,104,153
1261,1261,351,52,77,129
1262,1262,25,54,93,147
1263,1263,76,25,35,60
1264,1264,238,58,62,120
1265,1265,110,19,19,38
1266,1266,164,21,53,74
1267,1267,33,35,86,121
1268,1268,315,58,56,114
1269,1269,59,39,107,146
1270,1270,110,24,42,66
1271,1271,32,34,23,57
1272,1272,340,57,85,142
1273,1273,106,43,117,160
1274,1274,135,16,81,97
1275,1275,158,42,19,61
1276,1276,127,35,69,104
1277,1277,70,18,68,86
1278,1278,415,32,119,151
1279,1279,170,60,87,147
1280,1280,178,28,72,100
1281,1281,300,57,43,100
1282,1282,167,47,22,69
1283,1283,184,52,58,110
1284,1284,198,52,119,171
1285,1285,433,36,22,58
1286,1286,128,22,79,101
1287,1287,302,20,31,51
1288,1288,480,28,34,62
1289,1289,333,10,88,98
1290,1290,127,37,33,70
1291,1291,81,55,40,95
1292,1292,242,22,32,54
1293,1293,201,56,81,137
1294,1294,225,47,91,138
1295,1295,357,43,115,158
1296,1296,294,36,80,116
1297,1297,402,44,79,123
1298,1298,200,50,80,130
1299,1299,253,51,28,79
1300,1300,223,50,27,77
1301,1301,432,45,111,156
1302,1302,330,10,66,76
1303,1303,366,22,83,105
1304,1304,337,17,40,57
1305,1305,280,21,51,72
1306,1306,343,29,68,97
1307,1307,373,47,94,141
1308,1308,276,28,100,128
1309,1309,115,60,46,106
1310,1310,192,46,21,67
1311,1311,462,56,22,78
1312,1312,104,13,37,50
1313,1313,39,46,18,64
1314,1314,373,18,100,118
1315,1315,353,46,115,161
1316,1316,390,18,117,135
1317,1317,444,50,51,101
1318,1318,48,26,77,103
1319,1319,252,17,114,131
1320,1320,96,27,66,93
1321,1321,250,39,77,116
1322,1322,263,31,101,132
1323,1323,394,18,95,113
1324,1324,447,24,51,75
1325,1325,117,20,79,99
1326,1326,378,54,90,144
1327,1327,256,56,22,78
1328,1328,132,49,108,157
1329,1329,254,14,62,76
1330,1330,404,51,89,140
1331,1331,37,15,27,42
1332,1332,326,60,58,118
1333,1333,371,12,113,125
1334,1334,473,22,38,60
1335,1335,80,16,50,66
1336,1336,9,41,26,67
1337,1337,181,22,42,64
1338,1338,313,20,49,69
1339,1339,289,55,38,93
1340,1340,95,34,80,114
1341,1341,175,38,23,61
1342,1342,80,19,51,70
1343,1343,176,16,18,34
1344,1344,459,45,67,112
1345,1345,135,40,21,61
1346,1346,298,20,104,124
1347,1347,337,11,71,82
1348,1348,465,46,85,131
1349,1349,276,59,100,159
1350,1350,227,40,60,100
1351,1351,354,48,59,107
1352,1352,144,23,33,56
1353,1353,323,58,95,153
1354,1354,189,33,61,94
1355,1355,471,60,54,114
1356,1356,312,37,27,64
1357,1357,359,52,112,164
1358,1358,178,30,84,114
1359,1359,468,55,69,124
1360,1360,372,13,28,41
1361,1361,455,44,92,136
1362,1362,344,48,106,154
1363,1363,100,38,26,64
1364,1364,95,59,80,139
1365,1365,201,11,42,53
1366,1366,470,20,43,63
1367,1367,2,16,33,49
1368,1368,60,37,41,78
1369,1369,91,14,86,100
1370,1370,327,30,64,94
1371,1371,281,28,17,45
1372,1372,425,35,22,57
1373,1373,104,14,19,33
1374,1374,385,38,88,126
1375,1375,291,39,61,100
1376,1376,407,31,32,63
1377,1377,109,45,41,86
1378,1378,5,42,95,137
1379,1379,147,20,18,38
1380,1380,272,50,69,119
1381,1381,25,41,84,125
1382,1382,434,28,75,103
1383,1383,363,20,28,48
1384,1384,114,33,113,146
1385,1385,41,11,109,120
1386,1386,174,15,111,126
1387,1387,246,38,104,142
1388,1388,453,39,42,81
1389,1389,392,38,83,121
1390,1390,79,29,93,122
1391,1391,473,41,43,84
1392,1392,212,29,58,87
1393,1393,107,14,50,64
1394,1394,445,38,75,113
1395,1395,271,39,62,101
1396,1396,201,59,104,163
1397,1397,331,15,80,95
1398,1398,96,59,79,138
1399,1399,438,46,17,63
1400,1400,23,52,16,68
1401,1401,379,60,58,118
1402,1402,386,12,114,126
1403,1403,113,41,43,84
1404,1404,249,60,16,76
1405,1405,61,31,38,69
1406,1406,377,49,114,163
1407,1407,352,19,95,114
1408,1408,192,34,76,110
1409,1409,428,52,40,92
1410,1410,396,58,107,165
1411,1411,442,49,108,157
1412,1412,336,29,30,59
1413,1413,97,60,81,141
1414,1414,72,41,56,97
1415,1415,431,13,119,132
1416,1416,108,32,52,84
1417,1417,300,18,18,36
1418,1418,354,51,76,127
1419,1419,184,13,54,67
1420,1420,75,15,115,130
1421,1421,310,20,29,49
1422,1422,87,33,21,54
1423,1423,70,10,26,36
1424,1424,21,24,18,42
1425,1425,150,12,61,73
1426,1426,317,38,55,93
1427,1427,210,36,119,155
1428,1428,453,53,17,70
1429,1429,408,55,118,173
1430,1430,464,24,15,39
1431,1431,456,56,44,100
1432,1432,321,56,57,113
1433,1433,463,49,50,99
1434,1434,305,49,107,156
1435,1435,83,16,55,71
1436,1436,419,57,94,151
1437,1437,247,39,93,132
1438,1438,352,38,89,127
1439,1439,423,22,82,104
1440,1440,138,28,54,82
1441,1441,27,30,111,141
1442,1442,453,40,55,95
1443,1443,53,49,23,72
1444,1444,436,34,47,81
1445,1445,219,44,118,162
1446,1446,408,32,23,55
1447,1447,25,60,32,92
1448,1448,48,43,51,94
1449,1449,412,10,65,75
1450,1450,376,12,36,48
1451,1451,121,40,49,89
1452,1452,274,29,64,93
1453,1453,72,31,80,111
1454,1454,200,22,46,68
1455,1455,375,15,31,46
1456,1456,249,31,71,102
1457,1457,113,17,112,129
1458,1458,179,13,31,44
1459,1459,419,51,99,150
1460,1460,224,57,120,177
1461,1461,442,41,24,65
1462,1462,59,57,49,106
1463,1463,202,35,54,89
1464,1464,259,21,44,65
1465,1465,103,44,39,83
1466,1466,59,10,120,130
1467,1467,14,18,17,35
1468,1468,65,46,73,119
1469,1469,303,40,27,67
1470,1470,317,47,96,143
1471,1471,386,43,84,127
1472,1472,231,54,46,100
1473,1473,104,59,116,175
1474,1474,228,25,116,141
1475,1475,16,24,67,91
1476,1476,84,27,102,129
1477,1477,460,28,43,71
1478,1478,48,45,33,78
1479,1479,289,49,79,128
1480,1480,248,45,28,73
1481,1481,448,14,26,40
1482,1482,432,41,117,158
1483,1483,111,48,44,92
1484,1484,405,54,96,150
1485,1485,345,46,99,145
1486,1486,184,26,99,125
1487,1487,406,56,96,152
1488,1488,56,40,47,87
1489,1489,429,47,63,110
1490,1490,81,31,72,103
1491,1491,452,51,101,152
1492,1492,424,57,107,164
1493,1493,434,55,24,79
1494,1494,480,30,27,57
1495,1495,240,20,69,89
1496,1496,147,12,55,67
1497,1497,160,44,46,90
1498,1498,70,20,30,50
1499,1499,382,17,73,90
1500,1500,215,59,38,97
1501,1501,407,30,97,127
1502,1502,223,10,74,84
1503,1503,4,23,78,101
1504,1504,274,28,68,96
1505,1505,471,55,78,133
1506,1506,169,33,50,83
1507,1507,143,16,112,128
1508,1508,14,15,80,95
1509,1509,83,59,56,115
1510,1510,454,44,106,150
1511,1511,242,48,31,79
1512,1512,387,24,114,138
1513,1513,183,37,16,53
1514,1514,200,43,36,79
1515,1515,351,31,76,107
1516,1516,275,17,40,57
1517,1517,448,38,66,104
1518,1518,462,34,74,108
1519,1519,204,28,38,66
1520,1520,437,32,82,114
1521,1521,144,32,36,68
1522,1522,194,30,57,87
1523,1523,90,15,71,86
1524,1524,308,27,56,83
1525,1525,70,16,71,87
1526,1526,336,45,99,144
1527,1527,274,58,81,139
1528,1528,125,48,78,126
1529,1529,452,43,27,70
1530,1530,1,15,51,66
1531,1531,94,11,25,36
1532,1532,286,35,72,107
1533,1533,108,31,113,144
1534,1534,471,26,25,51
1535,1535,67,20,110,130
1536,1536,342,35,52,87
1537,1537,140,14,25,39
1538,1538,285,22,73,95
1539,1539,216,26,44,70
1540,1540,138,57,76,133
1541,1541,327,25,89,114
1542,1542,227,39,97,136
1543,1543,336,22,49,71
1544,1544,160,15,75,90
1545,1545,122,11,84,95
1546,1546,368,51,118,169
1547,1547,448,15,119,134
1548,1548,269,28,102,130
1549,1549,444,46,38,84
1550,1550,227,14,27,41
1551,1551,332,37,112,149
1552,1552,445,24,81,105
1553,1553,148,20,69,89
1554,1554,58,54,74,128
1555,1555,84,59,48,107
1556,1556,289,40,107,147
1557,1557,23,31,63,94
1558,1558,346,12,21,33
1559,1559,153,41,64,105
1560,1560,246,60,81,141
1561,1561,400,57,95,152
1562,1562,88,41,39,80
1563,1563,70,58,70,128
1564,1564,129,46,81,127
1565,1565,47,39,31,70
1566,1566,50,55,78,133
1567,1567,437,24,84,108
1568,1568,12,35,112,147
1569,1569,241,43,20,63
1570,1570,233,25,29,54
1571,1571,102,25,38,63
1572,1572,81,34,109,143
1573,1573,186,41,101,142
1574,1574,346,23,48,71
1575,1575,303,26,104,130
1576,1576,73,35,61,96
1577,1577,2,46,115,161
1578,1578,134,60,60,120
1579,1579,78,56,27,83
1580,1580,271,12,44,56
1581,1581,123,34,48,82
1582,1582,463,11,36,47
1583,1583,368,23,119,142
1584,1584,70,36,115,151
1585,1585,372,45,103,148
1586,1586,61,51,92,143
1587,1587,403,36,34,70
1588,1588,454,43,119,162
1589,1589,348,29,36,65
1590,1590,230,53,51,104
1591,1591,232,42,55,97
1592,1592,83,27,103,130
1593,1593,186,52,116,168
1594,1594,283,59,85,144
1595,1595,312,48,45,93
1596,1596,152,40,79,119
1597,1597,52,22,57,79
1598,1598,339,47,17,64
1599,1599,252,25,103,128
1600,1600,432,48,105,153
1601,1601,195,46,107,153
1602,1602,18,45,36,81
1603,1603,279,46,94,140
1604,1604,481,52,67,119
1605,1605,375,14,76,90
1606,1606,178,13,60,73
1607,1607,178,40,100,140
1608,1608,203,57,68,125
1609,1609,427,26,103,129
1610,1610,245,42,44,86
1611,1611,137,40,28,68
1612,1612,283,22,103,125
1613,1613,89,27,103,130
1614,1614,56,46,88,134
1615,1615,354,56,62,118
1616,1616,57,59,60,119
1617,1617,37,43,47,90
1618,1618,411,23,73,96
1619,1619,116,40,78,118
1620,1620,449,25,96,121
1621,1621,340,30,48,78
1622,1622,262,34,17,51
1623,1623,398,18,86,104
1624,1624,133,40,84,124
1625,1625,20,39,16,55
1626,1626,94,29,59,88
1627,1627,95,31,61,92
1628,1628,275,43,59,102
1629,1629,346,38,22,60
1630,1630,441,55,55,110
1631,1631,151,58,103,161
1632,1632,29,23,96,119
1633,1633,248,32,120,152
1634,1634,197,30,99,129
1635,1635,400,54,116,170
1636,1636,445,42,25,67
1637,1637,129,21,63,84
1638,1638,471,34,107,141
1639,1639,244,32,64,96
1640,1640,197,43,86,129
1641,1641,30,14,79,93
1642,1642,38,15,96,111
1643,1643,308,28,82,110
1644,1644,72,58,32,90
1645,1645,365,20,92,112
1646,1646,232,24,62,86
1647,1647,345,41,93,134
1648,1648,450,48,49,97
1649,1649,114,30,102,132
1650,1650,156,47,111,158
1651,1651,443,44,84,128
1652,1652,268,31,36,67
1653,1653,23,40,83,123
1654,1654,454,19,72,91
1655,1655,94,29,29,58
1656,1656,288,40,66,106
1657,1657,362,49,59,108
1658,1658,242,31,113,144
1659,1659,397,54,103,157
1660,1660,468,46,98,144
1661,1661,177,45,28,73
1662,1662,90,51,19,70
1663,1663,204,59,55,114
1664,1664,124,28,32,60
1665,1665,437,34,94,128
1666,1666,215,40,86,126
1667,1667,447,10,67,77
1668,1668,297,52,61,113
1669,1669,465,13,72,85
1670,1670,421,21,61,82
1671,1671,303,11,68,79
1672,1672,391,60,36,96
1673,1673,446,19,95,114
1674,1674,191,23,52,75
1675,1675,428,46,26,72
1676,1676,215,51,26,77
1677,1677,211,43,88,131
1678,1678,269,30,113,143
1679,1679,100,56,68,124
1680,1680,199,46,22,68
1681,1681,264,52,112,164
1682,1682,176,59,23,82
1683,1683,30,40,55,95
1684,1684,84,31,83,114
1685,1685,142,42,53,95
1686,1686,173,15,17,32
1687,1687,476,20,90,110
1688,1688,457,19,102,121
1689,1689,188,26,83,109
1690,1690,335,30,118,148
1691,1691,200,19,44,63
1692,1692,38,30,84,114
1693,1693,104,13,111,124
1694,1694,251,13,34,47
1695,1695,467,49,23,72
1696,1696,452,14,91,105
1697,1697,363,29,119,148
1698,1698,433,11,30,41
1699,1699,60,50,103,153
1700,1700,19,52,94,146
1701,1701,130,23,24,47
1702,1702,232,44,75,119
1703,1703,395,14,56,70
1704,1704,15,28,53,81
1705,1705,113,51,59,110
1706,1706,401,17,67,84
1707,1707,208,19,61,80
1708,1708,43,25,109,134
1709,1709,304,38,49,87
1710,1710,475,34,107,141
1711,1711,9,41,86,127
1712,1712,153,46,66,112
1713,1713,205,16,116,132
1714,1714,465,28,120,148
1715,1715,25,55,87,142
1716,1716,280,22,78,100
1717,1717,309,10,49,59
1718,1718,56,34,78,112
1719,1719,97,42,68,110
1720,1720,310,56,52,108
1721,1721,304,47,82,129
1722,1722,115,33,73,106
1723,1723,455,23,16,39
1724,1724,407,20,86,106
1725,1725,135,50,118,168
1726,1726,143,15,80,95
1727,1727,122,15,71,86
1728,1728,129,15,15,30
1729,1729,430,11,80,91
1730,1730,31,15,27,42
1731,1731,234,56,104,160
1732,1732,340,32,102,134
1733,1733,107,59,52,111
1734,1734,447,31,118,149
1735,1735,223,26,80,106
1736,1736,68,22,68,90
1737,1737,441,15,44,59
1738,1738,12,45,19,64
1739,1739,428,10,112,122
1740,1740,393,19,73,92
1741,1741,266,37,71,108
1742,1742,275,29,40,69
1743,1743,253,59,88,147
1744,1744,469,46,59,105
1745,1745,260,58,75,133
1746,1746,134,37,52,89
1747,1747,402,39,92,131
1748,1748,463,49,54,103
1749,1749,192,38,77,115
1750,1750,16,49,60,109
1751,1751,182,21,72,93
1752,1752,40,13,27,40
1753,1753,172,52,67,119
1754,1754,39,43,71,114
1755,1755,196,36,19,55
1756,1756,244,53,107,160
1757,1757,162,29,67,96
1758,1758,74,58,80,138
1759,1759,237,41,28,69
1760,1760,320,28,15,43
1761,1761,304,39,25,64
1762,1762,227,25,19,44
1763,1763,196,13,74,87
1764,1764,118,35,108,143
1765,1765,300,45,95,140
1766,1766,136,24,101,125
1767,1767,224,38,85,123
1768,1768,463,42,64,106
1769,1769,267,30,86,116
1770,1770,275,26,105,131
1771,1771,460,53,71,124
1772,1772,29,17,104,121
1773,1773,170,15,101,116
1774,1774,68,35,82,117
1775,1775,277,54,119,173
1776,1776,24,24,84,108
1777,1777,7,23,38,61
1778,1778,40,52,49,101
1779,1779,71,36,57,93
1780,1780,240,25,35,60
1781,1781,104,31,96,127
1782,1782,467,27,75,102
1783,1783,292,53,96,149
1784,1784,477,37,26,63
1785,1785,6,11,80,91
1786,1786,244,60,33,93
1787,1787,22,34,59,93
1788,1788,345,35,49,84
1789,1789,85,43,30,73
1790,1790,207,42,84,126
1791,1791,88,41,80,121
1792,1792,199,43,80,123
1793,1793,460,13,17,30
1794,1794,135,26,84,110
1795,1795,60,48,57,105
1796,1796,433,31,102,133
1797,1797,144,47,75,122
1798,1798,438,44,39,83
1799,1799,98,58,65,123
1800,1800,202,55,22,77
1801,1801,355,46,49,95
1802,1802,22,52,15,67
1803,1803,231,38,100,138
1804,1804,93,51,69,120
1805,1805,399,38,118,156
1806,1806,479,55,64,119
1807,1807,439,19,99,118
1808,1808,279,57,106,163
1809,1809,377,11,89,100
1810,1810,77,50,58,108
1811,1811,468,42,86,128
1812,1812,405,35,110,145
1813,1813,52,30,51,81
1814,1814,472,36,54,90
1815,1815,27,36,115,151
1816,1816,395,47,112,159
1817,1817,66,59,105,164
1818,1818,384,21,34,55
1819,1819,104,44,58,102
1820,1820,431,17,51,68
1821,1821,33,59,22,81
1822,1822,84,17,92,109
1823,1823,466,16,50,66
1824,1824,218,15,102,117
1825,1825,147,28,63,91
1826,1826,401,39,59,98
1827,1827,7,12,30,42
1828,1828,404,16,101,117
1829,1829,213,18,93,111
1830,1830,378,33,100,133
1831,1831,117,56,19,75
1832,1832,40,19,34,53
1833,1833,89,29,17,46
1834,1834,55,41,21,62
1835,1835,372,32,39,71
1836,1836,147,35,48,83
1837,1837,60,46,81,127
1838,1838,193,18,102,120
1839,1839,260,46,26,72
1840,1840,367,50,108,158
1841,1841,451,21,110,131
1842,1842,400,30,42,72
1843,1843,315,54,43,97
1844,1844,38,14,24,38
1845,1845,37,41,111,152
1846,1846,211,52,78,130
1847,1847,408,11,56,67
1848,1848,117,24,113,137
1849,1849,323,49,86,135
1850,1850,421,41,33,74
1851,1851,7,43,57,100
1852,1852,234,49,81,130
1853,1853,146,20,88,108
1854,1854,10,48,56,104
1855,1855,352,49,85,134
1856,1856,198,33,24,57
1857,1857,207,29,35,64
1858,1858,264,22,111,133
1859,1859,71,46,65,111
1860,1860,254,44,95,139
1861,1861,52,45,21,66
1862,1862,110,22,84,106
1863,1863,160,53,78,131
1864,1864,234,35,31,66
1865,1865,436,21,81,102
1866,1866,188,27,38,65
1867,1867,204,48,89,137
1868,1868,23,54,105,159
1869,1869,323,36,50,86
1870,1870,288,30,81,111
1871,1871,74,23,94,117
1872,1872,217,29,87,116
1873,1873,173,45,69,114
1874,1874,104,13,52,65
1875,1875,53,29,28,57
1876,1876,28,24,73,97
1877,1877,121,58,20,78
1878,1878,331,49,70,119
1879,1879,410,45,50,95
1880,1880,297,58,46,104
1881,1881,110,29,59,88
1882,1882,442,24,42,66
1883,1883,163,37,94,131
1884,1884,399,40,32,72
1885,1885,274,38,71,109
1886,1886,346,60,19,79
1887,1887,114,11,86,97
1888,1888,188,14,114,128
1889,1889,98,45,43,88
1890,1890,188,56,27,83
1891,1891,197,28,86,114
1892,1892,342,31,92,123
1893,1893,212,43,53,96
1894,1894,243,47,43,90
1895,1895,322,11,106,117
1896,1896,419,19,114,133
1897,1897,41,58,76,134
1898,1898,319,13,74,87
1899,1899,311,34,52,86
1900,1900,25,40,23,63
1901,1901,215,58,88,146
1902,1902,478,23,88,111
1903,1903,143,54,66,120
1904,1904,103,24,19,43
1905,1905,280,15,36,51
1906,1906,316,53,112,165
1907,1907,432,24,72,96
1908,1908,351,60,37,97
1909,1909,385,50,32,82
1910,1910,371,45,16,61
1911,1911,338,27,74,101
1912,1912,271,44,75,119
1913,1913,379,37,27,64
1914,1914,310,51,27,78
1915,1915,256,32,93,125
1916,1916,280,58,110,168
1917,1917,163,22,34,56
1918,1918,423,19,117,136
1919,1919,366,52,52,104
1920,1920,103,35,55,90
1921,1921,271,12,63,75
1922,1922,273,35,112,147
1923,1923,368,57,63,120
1924,1924,442,30,36,66
1925,1925,110,55,40,95
1926,1926,335,51,26,77
1927,1927,131,48,118,166
1928,1928,262,35,36,71
1929,1929,227,39,21,60
1930,1930,257,48,48,96
1931,1931,420,49,49,98
1932,1932,38,12,23,35
1933,1933,222,53,98,151
1934,1934,388,34,52,86
1935,1935,228,49,92,141
1936,1936,305,24,88,112
1937,1937,84,20,24,44
1938,1938,159,36,108,144
1939,1939,255,44,16,60
1940,1940,366,40,47,87
1941,1941,171,51,66,117
1942,1942,270,10,72,82
1943,1943,332,19,82,101
1944,1944,258,58,104,162
1945,1945,453,30,43,73
1946,1946,441,59,111,170
1947,1947,282,12,26,38
1948,1948,309,38,81,119
1949,1949,61,10,32,42
1950,1950,342,18,101,119
1951,1951,81,57,108,165
1952,1952,427,33,75,108
1953,1953,421,13,83,96
1954,1954,271,14,80,94
1955,1955,218,56,66,122
1956,1956,410,36,108,144
1957,1957,210,41,90,131
1958,1958,363,41,34,75
1959,1959,357,28,110,138
1960,1960,255,36,46,82
1961,1961,109,57,39,96
1962,1962,143,23,84,107
1963,1963,111,23,61,84
1964,1964,223,38,61,99
1965,1965,459,19,75,94
1966,1966,407,14,81,95
1967,1967,217,30,81,111
1968,1968,303,58,57,115
1969,1969,265,38,48,86
1970,1970,367,42,73,115
1971,1971,19,37,81,118
1972,1972,42,37,108,145
1973,1973,407,51,66,117
1974,1974,481,25,109,134
1975,1975,130,17,65,82
1976,1976,304,59,79,138
1977,1977,309,57,46,103
1978,1978,111,37,50,87
1979,1979,255,26,88,114
1980,1980,208,58,44,102
1981,1981,455,53,28,81
1982,1982,411,12,18,30
1983,1983,132,34,21,55
1984,1984,85,31,25,56
1985,1985,100,51,74,125
1986,1986,187,46,68,114
1987,1987,450,29,50,79
1988,1988,171,28,18,46
1989,1989,324,32,71,103
1990,1990,237,52,44,96
1991,1991,252,20,40,60
1992,1992,36,23,75,98
1993,1993,302,28,29,57
1994,1994,428,51,42,93
1995,1995,452,30,53,83
1996,1996,146,51,63,114
1997,1997,162,30,102,132
1998,1998,82,58,72,130
1999,1999,352,25,75,100
2000,2000,32,46,47,93
2001,2001,387,37,48,85
2002,2002,348,59,81,140
2003,2003,341,16,50,66
2004,2004,312,58,52,110
2005,2005,480,17,98,115
2006,2006,377,10,32,42
2007,2007,378,27,36,63
2008,2008,41,60,76,136
2009,2009,322,41,37,78
2010,2010,38,13,99,112
2011,2011,263,34,81,115
2012,2012,457,58,63,121
2013,2013,182,60,81,141
2014,2014,323,41,41,82
2015,2015,320,28,78,106
2016,2016,264,11,29,40
2017,2017,165,28,17,45
2018,2018,95,60,82,142
2019,2019,183,16,65,81
2020,2020,136,30,111,141
2021,2021,377,31,21,52
2022,2022,34,41,93,134
2023,2023,222,47,109,156
2024,2024,316,14,76,90
2025,2025,167,42,32,74
2026,2026,130,54,83,137
2027,2027,316,10,50,60
2028,2028,426,15,110,125
2029,2029,356,30,87,117
2030,2030,210,55,65,120
2031,2031,408,42,44,86
2032,2032,165,41,108,149
2033,2033,32,52,79,131
2034,2034,332,10,49,59
2035,2035,402,16,90,106
2036,2036,191,25,55,80
2037,2037,83,23,35,58
2038,2038,322,55,87,142
2039,2039,13,58,84,142
2040,2040,216,20,55,75
2041,2041,72,13,97,110
2042,2042,31,38,106,144
2043,2043,270,43,49,92
2044,2044,459,24,99,123
2045,2045,48,19,19,38
2046,2046,41,25,92,117
2047,2047,369,54,78,132
2048,2048,473,55,16,71
2049,2049,69,26,92,118
2050,2050,110,36,119,155
2051,2051,289,21,112,133
2052,2052,193,48,29,77
2053,2053,186,40,75,115
2054,2054,209,44,100,144
2055,2055,168,44,27,71
2056,2056,356,51,25,76
2057,2057,42,17,69,86
2058,2058,430,13,70,83
2059,2059,159,54,25,79
2060,2060,238,38,111,149
2061,2061,98,38,116,154
2062,2062,120,23,94,117
2063,2063,74,30,59,89
2064,2064,186,13,114,127
2065,2065,86,47,89,136
2066,2066,342,42,80,122
2067,2067,315,27,66,93
2068,2068,270,17,69,86
2069,2069,405,29,38,67
2070,2070,325,34,73,107
2071,2071,226,49,104,153
2072,2072,400,33,37,70
2073,2073,133,46,73,119
2074,2074,135,15,73,88
2075,2075,449,46,35,81
2076,2076,101,43,15,58
2077,2077,77,28,108,136
2078,2078,350,17,108,125
2079,2079,130,33,24,57
2080,2080,159,43,30,73
2081,2081,40,12,46,58
2082,2082,228,18,21,39
2083,2083,204,52,72,124
2084,2084,288,15,72,87
2085,2085,16,13,112,125
2086,2086,209,39,115,154
2087,2087,433,52,105,157
2088,2088,116,57,77,134
2089,2089,75,17,106,123
2090,2090,28,17,109,126
2091,2091,85,39,98,137
2092,2092,336,50,83,133
2093,2093,455,59,21,80
2094,2094,464,22,56,78
2095,2095,263,46,18,64
2096,2096,300,44,63,107
2097,2097,238,16,109,125
2098,2098,308,38,32,70
2099,2099,287,17,81,98
2100,2100,181,18,107,125
2101,2101,352,43,61,104
2102,2102,140,24,15,39
2103,2103,187,34,64,98
2104,2104,340,25,87,112
2105,2105,464,28,95,123
2106,2106,348,51,43,94
2107,2107,425,44,114,158
2108,2108,462,26,103,129
2109,2109,352,32,104,136
2110,2110,163,49,24,73
2111,2111,391,22,77,99
2112,2112,274,35,115,150
2113,2113,100,40,79,119
2114,2114,294,48,31,79
2115,2115,478,44,37,81
2116,2116,288,14,24,38
2117,2117,145,24,102,126
2118,2118,429,12,67,79
2119,2119,140,28,99,127
2120,2120,259,39,74,113
2121,2121,129,35,117,152
2122,2122,62,35,78,113
2123,2123,212,33,30,63
2124,2124,225,13,39,52
2125,2125,341,29,112,141
2126,2126,396,31,100,131
2127,2127,130,12,46,58
2128,2128,306,20,78,98
2129,2129,306,49,89,138
2130,2130,63,20,117,137
2131,2131,217,35,71,106
2132,2132,281,47,35,82
2133,2133,112,17,34,51
2134,2134,42,31,41,72
2135,2135,366,31,30,61
2136,2136,68,43,16,59
2137,2137,270,46,39,85
2138,2138,28,56,67,123
2139,2139,97,34,23,57
2140,2140,463,10,28,38
2141,2141,291,33,29,62
2142,2142,365,21,89,110
2143,2143,35,50,67,117
2144,2144,104,48,54,102
2145,2145,158,57,66,123
2146,2146,3,49,84,133
2147,2147,3,38,82,120
2148,2148,177,35,89,124
2149,2149,425,46,105,151
2150,2150,233,44,31,75
2151,2151,94,33,16,49
2152,2152,344,12,64,76
2153,2153,251,30,36,66
2154,2154,409,19,65,84
2155,2155,401,30,109,139
2156,2156,304,42,23,65
2157,2157,43,22,38,60
2158,2158,103,52,119,171
2159,2159,391,26,105,131
2160,2160,425,35,92,127
2161,2161,308,38,73,111
2162,2162,386,51,30,81
2163,2163,424,52,56,108
2164,2164,341,56,59,115
2165,2165,380,47,118,165
2166,2166,143,34,61,95
2167,2167,273,13,117,130
2168,2168,57,20,95,115
2169,2169,104,28,38,66
2170,2170,61,34,39,73
2171,2171,24,18,32,50
2172,2172,373,21,115,136
2173,2173,203,31,83,114
2174,2174,158,38,24,62
2175,2175,270,33,75,108
2176,2176,105,20,49,69
2177,2177,90,31,68,99
2178,2178,268,11,54,65
2179,2179,70,25,46,71
2180,2180,466,12,112,124
2181,2181,394,54,72,126
2182,2182,7,59,73,132
2183,2183,56,51,65,116
2184,2184,365,21,70,91
2185,2185,252,15,59,74
2186,2186,159,25,38,63
2187,2187,308,35,42,77
2188,2188,245,12,51,63
2189,2189,448,37,19,56
2190,2190,221,22,103,125
2191,2191,391,31,85,116
2192,2192,354,48,82,130
2193,2193,246,28,81,109
2194,2194,245,17,17,34
2195,2195,306,29,117,146
2196,2196,465,12,23,35
2197,2197,444,36,110,146
2198,2198,28,36,38,74
2199,2199,418,10,48,58
2200,2200,3,19,26,45
2201,2201,469,24,31,55
2202,2202,307,50,58,108
2203,2203,291,40,50,90
2204,2204,439,46,96,142
2205,2205,202,60,87,147
2206,2206,226,17,33,50
2207,2207,431,60,77,137
2208,2208,75,58,55,113
2209,2209,409,59,119,178
2210,2210,135,17,100,117
2211,2211,342,18,32,50
2212,2212,453,42,56,98
2213,2213,177,48,93,141
2214,2214,442,50,101,151
2215,2215,104,29,111,140
2216,2216,381,42,95,137
2217,2217,250,14,99,113
2218,2218,423,15,24,39
2219,2219,182,50,54,104
2220,2220,125,42,18,60
2221,2221,433,54,97,151
2222,2222,361,12,64,76
2223,2223,66,19,71,90
2224,2224,390,52,39,91
2225,2225,194,52,101,153
2226,2226,206,44,45,89
2227,2227,188,32,80,112
2228,2228,151,41,101,142
2229,2229,287,19,40,59
2230,2230,477,24,45,69
2231,2231,270,47,20,67
2232,2232,253,32,30,62
2233,2233,210,43,71,114
2234,2234,2,22,23,45
2235,2235,190,35,94,129
2236,2236,83,54,70,124
2237,2237,229,57,101,158
2238,2238,176,28,55,83
2239,2239,303,39,21,60
2240,2240,236,48,41,89
2241,2241,318,46,96,142
2242,2242,16,34,60,94
2243,2243,442,42,92,134
2244,2244,151,35,36,71
2245,2245,223,37,16,53
2246,2246,295,32,107,139
2247,2247,237,33,79,112
2248,2248,16,36,43,79
2249,2249,42,15,94,109
2250,2250,437,33,79,112
2251,2251,279,44,30,74
2252,2252,314,25,47,72
2253,2253,458,24,111,135
2254,2254,450,19,106,125
2255,2255,349,12,38,50
2256,2256,325,21,102,123
2257,2257,259,54,64,118
2258,2258,413,18,100,118
2259,2259,177,26,51,77
2260,2260,237,49,50,99
2261,2261,131,34,85,119
2262,2262,121,30,17,47
2263,2263,125,17,120,137
2264,2264,373,36,58,94
2265,2265,311,40,34,74
2266,2266,427,33,75,108
2267,2267,76,29,108,137
2268,2268,228,34,54,88
2269,2269,202,18,20,38
2270,2270,60,54,31,85
2271,2271,421,32,92,124
2272,2272,268,57,58,115
2273,2273,64,33,110,143
2274,2274,210,21,97,118
2275,2275,310,54,42,96
2276,2276,163,43,63,106
2277,2277,414,22,24,46
2278,2278,355,12,89,101
2279,2279,94,41,58,99
2280,2280,94,57,107,164
2281,2281,251,15,52,67
2282,2282,96,31,72,103
2283,2283,178,52,71,123
2284,2284,9,45,118,163
2285,2285,365,39,69,108
2286,2286,14,15,75,90
2287,2287,94,55,94,149
2288,2288,155,57,26,83
2289,2289,186,46,28,74
2290,2290,324,56,111,167
2291,2291,475,43,114,157
2292,2292,207,31,92,123
2293,2293,32,44,106,150
2294,2294,189,53,79,132
2295,2295,144,60,119,179
2296,2296,479,41,84,125
2297,2297,175,21,16,37
2298,2298,471,18,56,74
2299,2299,444,51,101,152
2300,2300,221,31,33,64
2301,2301,101,43,62,105
2302,2302,412,34,85,119
2303,2303,342,40,119,159
2304,2304,51,29,17,46
2305,2305,214,29,98,127
2306,2306,264,18,61,79
2307,2307,44,37,85,122
2308,2308,77,11,20,31
2309,2309,53,30,109,139
2310,2310,51,60,84,144
2311,2311,84,19,116,135
2312,2312,136,24,29,53
2313,2313,124,52,44,96
2314,2314,337,41,106,147
2315,2315,16,33,111,144
2316,2316,180,50,117,167
2317,2317,377,41,46,87
2318,2318,438,28,42,70
2319,2319,111,45,89,134
2320,2320,52,47,107,154
2321,2321,164,33,49,82
2322,2322,53,18,78,96
2323,2323,163,48,67,115
2324,2324,89,22,29,51
2325,2325,118,30,97,127
2326,2326,106,11,26,37
2327,2327,413,13,53,66
2328,2328,333,41,42,83
2329,2329,397,39,47,86
2330,2330,11,54,72,126
2331,2331,285,40,29,69
2332,2332,50,30,94,124
2333,2333,442,33,62,95
2334,2334,279,39,41,80
2335,2335,438,48,105,153
2336,2336,244,37,93,130
2337,2337,374,33,22,55
2338,2338,404,42,105,147
2339,2339,225,36,106,142
2340,2340,195,52,60,112
2341,2341,401,26,68,94
2342,2342,9,47,55,102
2343,2343,443,15,50,65
2344,2344,172,17,16,33
2345,2345,23,18,93,111
2346,2346,62,43,75,118
2347,2347,168,34,91,125
2348,2348,200,42,87,129
2349,2349,249,29,31,60
2350,2350,243,47,42,89
2351,2351,442,15,40,55
2352,2352,451,35,83,118
2353,2353,141,25,99,124
2354,2354,60,46,104,150
2355,2355,21,24,119,143
2356,2356,391,42,27,69
2357,2357,340,28,62,90
2358,2358,102,46,68,114
2359,2359,99,25,37,62
2360,2360,292,27,41,68
2361,2361,337,21,20,41
2362,2362,410,39,35,74
2363,2363,198,10,95,105
2364,2364,102,40,33,73
2365,2365,9,22,44,66
2366,2366,92,18,22,40
2367,2367,352,18,39,57
2368,2368,451,14,55,69
2369,2369,147,60,65,125
2370,2370,145,15,53,68
2371,2371,227,59,95,154
2372,2372,350,33,34,67
2373,2373,40,39,81,120
2374,2374,339,39,68,107
2375,2375,190,42,116,158
2376,2376,296,28,95,123
2377,2377,215,32,42,74
2378,2378,75,43,77,120
2379,2379,270,20,30,50
2380,2380,124,21,113,134
2381,2381,403,56,54,110
2382,2382,451,51,65,116
2383,2383,321,51,111,162
2384,2384,51,16,97,113
2385,2385,341,58,67,125
2386,2386,340,53,118,171
2387,2387,134,58,26,84
2388,2388,301,44,75,119
2389,2389,268,42,43,85
2390,2390,142,20,37,57
2391,2391,40,55,47,102
2392,2392,171,47,99,146
2393,2393,470,38,114,152
2394,2394,349,28,22,50
2395,2395,461,17,96,113
2396,2396,215,18,120,138
2397,2397,123,44,32,76
2398,2398,20,30,46,76
2399,2399,170,45,105,150
2400,2400,289,49,93,142
2401,2401,279,48,103,151
2402,2402,93,20,69,89
2403,2403,59,12,85,97
2404,2404,381,27,97,124
2405,2405,382,16,77,93
2406,2406,167,26,119,145
2407,2407,248,37,100,137
2408,2408,63,33,26,59
2409,2409,172,25,99,124
2410,2410,272,54,42,96
2411,2411,431,19,24,43
2412,2412,173,59,23,82
2413,2413,152,54,97,151
2414,2414,102,53,52,105
2415,2415,376,57,36,93
2416,2416,182,40,55,95
2417,2417,330,34,83,117
2418,2418,316,10,68,78
2419,2419,59,43,92,135
2420,2420,405,59,62,121
2421,2421,225,37,105,142
2422,2422,104,11,74,85
2423,2423,221,39,72,111
2424,2424,374,31,30,61
2425,2425,361,18,76,94
2426,2426,360,52,64,116
2427,2427,280,15,111,126
2428,2428,9,18,58,76
2429,2429,7,24,94,118
2430,2430,229,51,28,79
2431,2431,87,52,16,68
2432,2432,360,38,59,97
2433,2433,110,16,115,131
2434,2434,420,27,28,55
2435,2435,21,51,85,136
2436,2436,12,29,52,81
2437,2437,221,38,16,54
2438,2438,339,39,110,149
2439,2439,124,32,33,65
2440,2440,44,26,54,80
2441,2441,390,30,15,45
2442,2442,1,54,105,159
2443,2443,202,56,92,148
2444,2444,430,53,55,108
2445,2445,156,13,23,36
2446,2446,103,16,47,63
2447,2447,452,43,117,160
2448,2448,254,43,47,90
2449,2449,22,50,90,140
2450,2450,227,32,61,93
2451,2451,374,36,44,80
2452,2452,303,52,20,72
2453,2453,313,31,16,47
2454,2454,370,39,28,67
2455,2455,147,10,75,85
2456,2456,478,15,41,56
2457,2457,480,50,74,124
2458,2458,256,49,44,93
2459,2459,43,24,68,92
2460,2460,290,16,27,43
2461,2461,200,48,96,144
2462,2462,434,42,119,161
2463,2463,473,12,107,119
2464,2464,117,36,80,116
2465,2465,87,23,68,91
2466,2466,440,56,52,108
2467,2467,16,30,40,70
2468,2468,295,18,43,61
2469,2469,262,57,83,140
2470,2470,476,22,35,57
2471,2471,439,30,104,134
2472,2472,272,13,29,42
2473,2473,402,32,35,67
2474,2474,466,47,85,132
2475,2475,94,46,49,95
2476,2476,248,30,43,73
2477,2477,191,13,38,51
2478,2478,359,20,48,68
2479,2479,240,49,94,143
2480,2480,306,31,46,77
2481,2481,70,47,98,145
2482,2482,5,24,108,132
2483,2483,211,28,40,68
2484,2484,226,20,104,124
2485,2485,435,19,85,104
2486,2486,412,22,111,133
2487,2487,342,20,105,125
2488,2488,444,24,84,108
2489,2489,312,31,43,74
2490,2490,180,28,39,67
2491,2491,356,21,117,138
2492,2492,160,27,45,72
2493,2493,96,31,82,113
2494,2494,205,37,60,97
2495,2495,317,36,46,82
2496,2496,448,12,29,41
2497,2497,252,18,40,58
2498,2498,314,25,36,61
2499,2499,454,15,25,40
2500,2500,135,29,117,146
2501,2501,353,60,22,82
2502,2502,4,23,22,45
2503,2503,145,46,47,93
2504,2504,284,26,110,136
2505,2505,348,44,60,104
2506,2506,50,54,113,167
2507,2507,441,21,58,79
2508,2508,419,34,49,83
2509,2509,367,40,69,109
2510,2510,198,22,89,111
2511,2511,303,50,95,145
2512,2512,212,24,119,143
2513,2513,445,11,27,38
2514,2514,288,48,67,115
2515,2515,335,18,112,130
2516,2516,46,48,49,97
2517,2517,109,55,22,77
2518,2518,243,50,106,156
2519,2519,65,42,63,105
2520,2520,105,19,96,115
2521,2521,344,38,101,139
2522,2522,404,45,92,137
2523,2523,211,59,27,86
2524,2524,144,25,119,144
2525,2525,57,46,98,144
2526,2526,396,16,117,133
2527,2527,366,50,50,100
2528,2528,40,46,78,124
2529,2529,407,45,78,123
2530,2530,286,30,81,111
2531,2531,129,16,86,102
2532,2532,18,12,118,130
2533,2533,6,36,50,86
2534,2534,44,14,80,94
2535,2535,409,33,54,87
2536,2536,233,48,91,139
2537,2537,158,27,22,49
2538,2538,267,26,91,117
2539,2539,123,59,119,178
2540,2540,419,44,97,141
2541,2541,185,37,21,58
2542,2542,147,15,35,50
2543,2543,359,10,72,82
2544,2544,382,28,27,55
2545,2545,68,45,61,106
2546,2546,228,27,106,133
2547,2547,230,49,76,125
2548,2548,148,11,90,101
2549,2549,227,28,48,76
2550,2550,403,37,82,119
2551,2551,327,38,96,134
2552,2552,62,22,42,64
2553,2553,47,58,28,86
2554,2554,107,19,114,133
2555,2555,15,54,93,147
2556,2556,254,51,34,85
2557,2557,6,48,59,107
2558,2558,446,32,72,104
2559,2559,25,46,71,117
2560,2560,107,51,108,159
2561,2561,370,36,111,147
2562,2562,458,15,22,37
2563,2563,126,38,75,113
2564,2564,479,40,77,117
2565,2565,342,36,93,129
2566,2566,225,43,106,149
2567,2567,109,27,113,140
2568,2568,117,13,94,107
2569,2569,48,53,81,134
2570,2570,6,56,98,154
2571,2571,128,31,56,87
2572,2572,6,33,77,110
2573,2573,379,40,32,72
2574,2574,120,45,117,162
2575,2575,322,34,96,130
2576,2576,388,27,47,74
2577,2577,252,26,107,133
2578,2578,389,22,116,138
2579,2579,161,31,54,85
2580,2580,169,39,52,91
2581,2581,223,59,105,164
2582,2582,158,59,111,170
2583,2583,259,16,56,72
2584,2584,3,19,28,47
2585,2585,261,60,20,80
2586,2586,125,55,26,81
2587,2587,351,53,19,72
2588,2588,5,16,97,113
2589,2589,219,23,65,88
2590,2590,91,40,65,105
2591,2591,86,30,44,74
2592,2592,409,55,21,76
2593,2593,169,32,115,147
2594,2594,54,47,69,116
2595,2595,267,52,58,110
2596,2596,179,12,106,118
2597,2597,64,47,104,151
2598,2598,146,15,59,74
2599,2599,316,55,75,130
2600,2600,60,14,25,39
2601,2601,19,54,68,122
2602,2602,178,15,94,109
2603,2603,451,15,35,50
2604,2604,402,25,55,80
2605,2605,88,34,44,78
2606,2606,250,12,24,36
2607,2607,215,29,117,146
2608,2608,354,30,99,129
2609,2609,358,35,115,150
2610,2610,130,22,60,82
2611,2611,7,48,59,107
2612,2612,63,50,25,75
2613,2613,24,34,59,93
2614,2614,362,50,34,84
2615,2615,258,20,102,122
2616,2616,225,50,55,105
2617,2617,458,11,105,116
2618,2618,206,43,76,119
2619,2619,450,10,63,73
2620,2620,338,49,58,107
2621,2621,249,28,120,148
2622,2622,229,11,51,62
2623,2623,348,31,36,67
2624,2624,194,15,108,123
2625,2625,401,24,55,79
2626,2626,166,53,112,165
2627,2627,465,30,92,122
2628,2628,98,14,46,60
2629,2629,291,47,76,123
2630,2630,330,20,64,84
2631,2631,204,22,26,48
2632,2632,430,36,43,79
2633,2633,370,42,81,123
2634,2634,107,33,19,52
2635,2635,20,33,57,90
2636,2636,252,31,119,150
2637,2637,461,43,118,161
2638,2638,46,37,44,81
2639,2639,246,16,33,49
2640,2640,423,43,109,152
2641,2641,439,35,47,82
2642,2642,396,42,101,143
2643,2643,200,54,54,108
2644,2644,47,36,36,72
2645,2645,383,25,83,108
2646,2646,281,34,59,93
2647,2647,98,14,88,102
2648,2648,303,54,56,110
2649,2649,11,44,64,108
2650,2650,138,39,36,75
2651,2651,219,31,61,92
2652,2652,287,27,98,125
2653,2653,428,44,102,146
2654,2654,446,17,96,113
2655,2655,376,50,97,147
2656,2656,58,39,94,133
2657,2657,418,39,87,126
2658,2658,447,49,18,67
2659,2659,338,13,120,133
2660,2660,278,33,56,89
2661,2661,92,30,84,114
2662,2662,164,21,56,77
2663,2663,55,43,68,111
2664,2664,401,59,95,154
2665,2665,399,31,28,59
2666,2666,254,38,109,147
2667,2667,294,34,39,73
2668,2668,43,17,30,47
2669,2669,144,46,71,117
2670,2670,271,36,76,112
2671,2671,414,46,68,114
2672,2672,34,22,26,48
2673,2673,426,36,22,58
2674,2674,383,35,20,55
2675,2675,418,46,32,78
2676,2676,450,46,54,100
2677,2677,81,50,23,73
2678,2678,477,47,63,110
2679,2679,271,58,61,119
2680,2680,62,45,112,157
2681,2681,166,34,19,53
2682,2682,15,35,45,80
2683,2683,136,29,22,51
2684,2684,48,46,18,64
2685,2685,261,25,116,141
2686,2686,201,16,97,113
2687,2687,312,51,98,149
2688,2688,454,54,24,78
2689,2689,410,42,31,73
2690,2690,479,35,55,90
2691,2691,452,23,41,64
2692,2692,404,43,71,114
2693,2693,432,10,117,127
2694,2694,318,33,116,149
2695,2695,246,50,110,160
2696,2696,89,50,69,119
2697,2697,264,30,16,46
2698,2698,191,58,115,173
2699,2699,386,41,118,159
2700,2700,140,48,67,115
2701,2701,408,52,77,129
2702,2702,180,15,102,117
2703,2703,108,26,29,55
2704,2704,291,17,18,35
2705,2705,130,23,115,138
2706,2706,93,46,118,164
2707,2707,350,34,119,153
2708,2708,277,21,26,47
2709,2709,50,38,96,134
2710,2710,389,41,109,150
2711,2711,45,14,28,42
2712,2712,278,19,86,105
2713,2713,28,25,69,94
2714,2714,470,16,42,58
2715,2715,85,26,26,52
2716,2716,170,23,88,111
2717,2717,195,31,77,108
2718,2718,425,20,68,88
2719,2719,278,35,103,138
2720,2720,132,11,74,85
2721,2721,441,45,27,72
2722,2722,453,57,91,148
2723,2723,8,21,22,43
2724,2724,87,58,74,132
2725,2725,374,30,100,130
2726,2726,166,12,26,38
2727,2727,368,37,118,155
2728,2728,381,15,106,121
2729,2729,87,43,41,84
2730,2730,122,17,71,88
2731,2731,276,41,25,66
2732,2732,398,19,16,35
2733,2733,128,25,27,52
2734,2734,391,31,117,148
2735,2735,454,46,85,131
2736,2736,173,54,58,112
2737,2737,332,35,46,81
2738,2738,90,58,89,147
2739,2739,94,19,91,110
2740,2740,321,48,83,131
2741,2741,270,26,57,83
2742,2742,437,38,35,73
2743,2743,250,11,106,117
2744,2744,283,44,77,121
2745,2745,137,55,38,93
2746,2746,31,11,74,85
2747,2747,99,30,24,54
2748,2748,326,36,38,74
2749,2749,326,17,97,114
2750,2750,209,49,97,146
2751,2751,209,19,51,70
2752,2752,297,25,96,121
2753,2753,283,39,107,146
2754,2754,171,25,89,114
2755,2755,239,33,103,136
2756,2756,323,53,74,127
2757,2757,340,24,28,52
2758,2758,392,35,120,155
2759,2759,464,35,117,152
2760,2760,137,51,30,81
2761,2761,129,25,69,94
2762,2762,256,14,80,94
2763,2763,151,20,50,70
2764,2764,42,59,93,152
2765,2765,443,45,104,149
2766,2766,333,25,113,138
2767,2767,341,58,46,104
2768,2768,385,27,26,53
2769,2769,423,12,109,121
2770,2770,238,18,26,44
2771,2771,300,31,47,78
2772,2772,319,18,85,103
2773,2773,122,10,110,120
2774,2774,295,16,39,55
2775,2775,62,55,49,104
2776,2776,319,60,92,152
2777,2777,129,58,112,170
2778,2778,28,44,77,121
2779,2779,201,44,49,93
2780,2780,267,40,97,137
2781,2781,65,11,93,104
2782,2782,232,41,97,138
2783,2783,332,42,32,74
2784,2784,358,44,94,138
2785,2785,434,26,44,70
2786,2786,12,17,40,57
2787,2787,375,60,33,93
2788,2788,159,45,93,138
2789,2789,384,42,80,122
2790,2790,282,14,85,99
2791,2791,392,15,29,44
2792,2792,374,52,105,157
2793,2793,169,19,44,63
2794,2794,424,10,76,86
2795,2795,108,59,35,94
2796,2796,30,30,22,52
2797,2797,26,33,39,72
2798,2798,3,26,83,109
2799,2799,456,39,23,62
2800,2800,467,50,104,154
2801,2801,327,54,98,152
2802,2802,149,51,26,77
2803,2803,187,60,118,178
2804,2804,15,42,28,70
2805,2805,2,49,30,79
2806,2806,107,14,96,110
2807,2807,236,15,26,41
2808,2808,53,19,105,124
2809,2809,76,38,58,96
2810,2810,388,40,102,142
2811,2811,226,21,51,72
2812,2812,176,50,111,161
2813,2813,292,30,21,51
2814,2814,365,26,34,60
2815,2815,258,28,83,111
2816,2816,21,46,55,101
2817,2817,62,34,29,63
2818,2818,125,47,77,124
2819,2819,131,17,58,75
2820,2820,415,32,105,137
2821,2821,202,46,82,128
2822,2822,211,41,53,94
2823,2823,291,51,40,91
2824,2824,18,37,45,82
2825,2825,271,43,37,80
2826,2826,97,26,72,98
2827,2827,113,47,88,135
2828,2828,212,11,33,44
2829,2829,170,20,20,40
2830,2830,140,52,74,126
2831,2831,3,51,93,144
2832,2832,368,46,37,83
2833,2833,122,33,19,52
2834,2834,287,36,54,90
2835,2835,285,13,103,116
2836,2836,157,24,62,86
2837,2837,110,45,96,141
2838,2838,291,43,120,163
2839,2839,262,43,16,59
2840,2840,382,30,31,61
2841,2841,12,41,86,127
2842,2842,237,31,66,97
2843,2843,54,47,33,80
2844,2844,127,56,34,90
2845,2845,255,15,108,123
2846,2846,185,13,19,32
2847,2847,290,14,89,103
2848,2848,218,29,33,62
2849,2849,473,25,40,65
2850,2850,379,47,39,86
2851,2851,86,17,43,60
2852,2852,75,25,69,94
2853,2853,453,32,99,131
2854,2854,60,48,86,134
2855,2855,47,20,51,71
2856,2856,275,54,101,155
2857,2857,289,42,105,147
2858,2858,370,24,106,130
2859,2859,27,40,58,98
2860,2860,364,59,86,145
2861,2861,227,26,37,63
2862,2862,303,39,34,73
2863,2863,13,57,45,102
2864,2864,450,10,93,103
2865,2865,272,55,45,100
2866,2866,401,24,119,143
2867,2867,379,51,35,86
2868,2868,70,49,113,162
2869,2869,115,47,63,110
2870,2870,319,52,29,81
2871,2871,365,45,44,89
2872,2872,183,33,46,79
2873,2873,242,19,100,119
2874,2874,300,38,78,116
2875,2875,225,52,24,76
2876,2876,131,48,73,121
2877,2877,104,58,15,73
2878,2878,62,43,60,103
2879,2879,3,32,52,84
2880,2880,429,21,16,37
2881,2881,140,25,15,40
2882,2882,47,33,48,81
2883,2883,154,40,42,82
2884,2884,63,30,45,75
2885,2885,108,39,75,114
2886,2886,354,43,51,94
2887,2887,24,52,31,83
2888,2888,203,44,68,112
2889,2889,428,24,44,68
2890,2890,405,49,94,143
2891,2891,273,11,76,87
2892,2892,289,58,55,113
2893,2893,147,51,23,74
2894,2894,79,39,33,72
2895,2895,473,50,17,67
2896,2896,230,44,101,145
2897,2897,18,36,58,94
2898,2898,285,24,107,131
2899,2899,286,60,48,108
2900,2900,151,28,17,45
2901,2901,121,12,82,94
2902,2902,12,32,52,84
2903,2903,468,26,112,138
2904,2904,205,53,92,145
2905,2905,191,29,120,149
2906,2906,407,14,38,52
2907,2907,193,35,96,131
2908,2908,5,13,103,116
2909,2909,186,41,22,63
2910,2910,128,60,118,178
2911,2911,328,45,79,124
2912,2912,168,30,86,116
2913,2913,470,34,24,58
2914,2914,135,16,112,128
2915,2915,145,52,110,162
2916,2916,480,51,95,146
2917,2917,253,53,37,90
2918,2918,250,42,74,116
2919,2919,387,41,36,77
2920,2920,58,30,31,61
2921,2921,66,58,101,159
2922,2922,92,45,22,67
2923,2923,355,23,120,143
2924,2924,373,33,119,152
2925,2925,436,36,116,152
2926,2926,7,13,87,100
2927,2927,274,53,90,143
2928,2928,173,12,22,34
2929,2929,219,21,18,39
2930,2930,242,29,22,51
2931,2931,9,11,96,107
2932,2932,86,50,38,88
2933,2933,52,46,67,113
2934,2934,336,30,28,58
2935,2935,54,32,55,87
2936,2936,416,10,27,37
2937,2937,16,52,77,129
2938,2938,322,53,83,136
2939,2939,70,37,108,145
2940,2940,273,54,118,172
2941,2941,208,50,93,143
2942,2942,134,16,92,108
2943,2943,93,15,56,71
2944,2944,424,58,65,123
2945,2945,131,55,111,166
2946,2946,131,11,54,65
2947,2947,22,41,38,79
2948,2948,267,48,107,155
2949,2949,141,27,47,74
2950,2950,317,31,102,133
2951,2951,419,35,57,92
2952,2952,170,53,25,78
2953,2953,18,58,25,83
2954,2954,322,15,106,121
2955,2955,106,26,70,96
2956,2956,32,47,26,73
2957,2957,444,42,19,61
2958,2958,348,30,91,121
2959,2959,265,27,79,106
2960,2960,452,23,107,130
2961,2961,447,25,118,143
2962,2962,84,49,98,147
2963,2963,193,54,47,101
2964,2964,374,25,72,97
2965,2965,149,38,40,78
2966,2966,196,56,75,131
2967,2967,159,11,91,102
2968,2968,106,53,60,113
2969,2969,170,28,31,59
2970,2970,342,13,59,72
2971,2971,171,53,24,77
2972,2972,4,14,67,81
2973,2973,440,38,74,112
2974,2974,217,26,116,142
2975,2975,257,52,106,158
2976,2976,252,22,67,89
2977,2977,168,29,30,59
2978,2978,271,11,119,130
2979,2979,166,36,30,66
2980,2980,202,34,40,74
2981,2981,415,57,32,89
2982,2982,195,24,22,46
2983,2983,356,26,47,73
2984,2984,302,30,104,134
2985,2985,225,55,53,108
2986,2986,182,13,109,122
2987,2987,98,20,32,52
2988,2988,48,47,24,71
2989,2989,185,34,43,77
2990,2990,410,40,16,56
2991,2991,256,51,45,96
2992,2992,213,16,22,38
2993,2993,378,30,119,149
2994,2994,435,11,102,113
2995,2995,348,45,118,163
2996,2996,11,50,75,125
2997,2997,406,25,56,81
2998,2998,452,47,19,66
2999,2999,427,50,63,113
3000,3000,74,60,58,118
3001,3001,127,44,54,98
3002,3002,271,43,30,73
3003,3003,93,51,68,119
3004,3004,274,19,110,129
3005,3005,169,27,56,83
3006,3006,151,58,68,126
3007,3007,243,20,32,52
3008,3008,374,59,44,103
3009,3009,86,30,59,89
3010,3010,393,25,77,102
3011,3011,425,51,82,133
3012,3012,78,19,23,42
3013,3013,29,33,49,82
3014,3014,416,50,106,156
3015,3015,235,29,61,90
3016,3016,240,15,99,114
3017,3017,164,50,73,123
3018,3018,358,17,118,135
3019,3019,395,15,33,48
3020,3020,414,29,34,63
3021,3021,330,17,24,41
3022,3022,265,18,111,129
3023,3023,384,31,18,49
3024,3024,40,37,96,133
3025,3025,388,55,61,116
3026,3026,317,33,102,135
3027,3027,262,42,118,160
3028,3028,223,59,30,89
3029,3029,425,16,103,119
3030,3030,293,55,44,99
3031,3031,340,39,102,141
3032,3032,295,50,53,103
3033,3033,43,32,113,145
3034,3034,276,41,21,62
3035,3035,466,29,64,93
3036,3036,209,30,66,96
3037,3037,60,31,82,113
3038,3038,131,23,93,116
3039,3039,372,60,72,132
3040,3040,443,29,21,50
3041,3041,4,45,40,85
3042,3042,465,39,82,121
3043,3043,184,59,25,84
3044,3044,271,47,77,124
3045,3045,39,39,72,111
3046,3046,353,53,69,122
3047,3047,170,58,81,139
3048,3048,14,20,118,138
3049,3049,76,54,40,94
3050,3050,230,57,64,121
3051,3051,67,46,92,138
3052,3052,98,36,68,104
3053,3053,390,58,104,162
3054,3054,250,16,58,74
3055,3055,207,42,20,62
3056,3056,192,56,73,129
3057,3057,91,17,38,55
3058,3058,348,37,31,68
3059,3059,159,14,72,86
3060,3060,59,37,25,62
3061,3061,147,26,36,62
3062,3062,241,60,96,156
3063,3063,266,10,18,28
3064,3064,404,44,119,163
3065,3065,179,45,38,83
3066,3066,69,24,91,115
3067,3067,385,11,47,58
3068,3068,397,25,29,54
3069,3069,190,38,54,92
3070,3070,370,27,106,133
3071,3071,3,20,112,132
3072,3072,456,47,33,80
3073,3073,69,17,82,99
3074,3074,409,10,65,75
3075,3075,329,52,120,172
3076,3076,200,43,63,106
3077,3077,77,44,99,143
3078,3078,455,24,36,60
3079,3079,186,57,82,139
3080,3080,231,46,56,102
3081,3081,100,18,20,38
3082,3082,21,21,120,141
3083,3083,422,56,41,97
3084,3084,112,20,39,59
3085,3085,166,55,57,112
3086,3086,187,14,112,126
3087,3087,78,12,68,80
3088,3088,453,47,39,86
3089,3089,412,19,60,79
3090,3090,429,44,41,85
3091,3091,67,38,67,105
3092,3092,162,57,110,167
3093,3093,252,18,75,93
3094,3094,137,32,111,143
3095,3095,92,16,112,128
3096,3096,171,40,93,133
3097,3097,194,37,32,69
3098,3098,298,47,115,162
3099,3099,77,52,18,70
3100,3100,407,15,120,135
3101,3101,365,21,77,98
3102,3102,170,34,61,95
3103,3103,182,13,59,72
3104,3104,315,58,83,141
3105,3105,162,24,37,61
3106,3106,310,37,54,91
3107,3107,400,23,44,67
3108,3108,474,45,54,99
3109,3109,145,23,89,112
3110,3110,117,52,29,81
3111,3111,44,60,41,101
3112,3112,356,47,33,80
3113,3113,250,58,71,129
3114,3114,401,60,48,108
3115,3115,54,27,57,84
3116,3116,196,52,66,118
3117,3117,460,59,16,75
3118,3118,41,60,53,113
3119,3119,296,32,118,150
3120,3120,139,16,101,117
3121,3121,145,35,56,91
3122,3122,20,15,83,98
3123,3123,443,21,45,66
3124,3124,51,15,91,106
3125,3125,331,51,85,136
3126,3126,109,40,17,57
3127,3127,116,21,33,54
3128,3128,217,23,30,53
3129,3129,361,35,21,56
3130,3130,149,16,76,92
3131,3131,152,59,99,158
3132,3132,184,13,65,78
3133,3133,50,35,41,76
3134,3134,72,26,76,102
3135,3135,76,48,18,66
3136,3136,42,27,26,53
3137,3137,236,38,48,86
3138,3138,218,36,55,91
3139,3139,301,28,101,129
3140,3140,194,51,88,139
3141,3141,468,55,57,112
3142,3142,334,55,87,142
3143,3143,172,20,88,108
3144,3144,455,31,92,123
3145,3145,465,30,62,92
3146,3146,192,39,75,114
3147,3147,432,58,112,170
3148,3148,154,46,49,95
3149,3149,256,39,27,66
3150,3150,426,20,72,92
3151,3151,197,32,67,99
3152,3152,41,26,59,85
3153,3153,103,60,60,120
3154,3154,178,15,62,77
3155,3155,33,29,117,146
3156,3156,412,19,51,70
3157,3157,118,50,88,138
3158,3158,349,58,78,136
3159,3159,39,40,63,103
3160,3160,316,31,63,94
3161,3161,414,36,85,121
3162,3162,344,20,26,46
3163,3163,271,14,57,71
3164,3164,125,12,62,74
3165,3165,480,39,51,90
3166,3166,412,53,68,121
3167,3167,432,55,26,81
3168,3168,185,20,28,48
3169,3169,451,55,117,172
3170,3170,396,18,51,69
3171,3171,189,48,72,120
3172,3172,410,35,22,57
3173,3173,14,44,79,123
3174,3174,260,46,17,63
3175,3175,289,36,31,67
3176,3176,301,27,101,128
3177,3177,259,19,38,57
3178,3178,94,18,45,63
3179,3179,403,50,113,163
3180,3180,208,27,22,49
3181,3181,442,55,35,90
3182,3182,334,47,73,120
3183,3183,279,28,42,70
3184,3184,106,20,118,138
3185,3185,423,30,114,144
3186,3186,312,22,34,56
3187,3187,160,19,82,101
3188,3188,226,29,45,74
3189,3189,33,14,69,83
3190,3190,87,53,59,112
3191,3191,170,37,48,85
3192,3192,345,27,73,100
3193,3193,392,59,91,150
3194,3194,448,49,71,120
3195,3195,470,47,92,139
3196,3196,228,55,69,124
3197,3197,170,10,99,109
3198,3198,124,38,89,127
3199,3199,274,42,29,71
3200,3200,318,14,26,40
3201,3201,363,58,49,107
3202,3202,377,25,45,70
3203,3203,352,36,98,134
3204,3204,114,16,28,44
3205,3205,360,32,31,63
3206,3206,70,42,37,79
3207,3207,308,12,59,71
3208,3208,296,40,91,131
3209,3209,364,31,68,99
3210,3210,7,38,100,138
3211,3211,60,34,95,129
3212,3212,438,33,119,152
3213,3213,244,25,55,80
3214,3214,200,43,101,144
3215,3215,41,60,107,167
3216,3216,85,22,93,115
3217,3217,348,35,101,136
3218,3218,256,38,17,55
3219,3219,7,60,69,129
3220,3220,477,19,102,121
3221,3221,280,18,83,101
3222,3222,312,47,46,93
3223,3223,246,13,102,115
3224,3224,205,22,30,52
3225,3225,386,15,80,95
3226,3226,19,35,88,123
3227,3227,241,23,54,77
3228,3228,30,46,115,161
3229,3229,305,17,114,131
3230,3230,342,29,91,120
3231,3231,298,27,17,44
3232,3232,287,60,48,108
3233,3233,439,47,63,110
3234,3234,411,26,105,131
3235,3235,478,19,118,137
3236,3236,67,56,70,126
3237,3237,427,23,52,75
3238,3238,365,39,104,143
3239,3239,238,35,59,94
3240,3240,338,42,45,87
3241,3241,389,41,77,118
3242,3242,296,43,42,85
3243,3243,161,14,41,55
3244,3244,36,17,78,95
3245,3245,468,40,61,101
3246,3246,470,44,62,106
3247,3247,240,33,35,68
3248,3248,439,57,117,174
3249,3249,75,43,92,135
3250,3250,419,46,28,74
3251,3251,458,46,41,87
3252,3252,168,45,51,96
3253,3253,116,26,30,56
3254,3254,392,48,35,83
3255,3255,270,35,116,151
3256,3256,47,15,100,115
3257,3257,294,10,71,81
3258,3258,7,14,25,39
3259,3259,125,42,117,159
3260,3260,178,16,98,114
3261,3261,178,53,20,73
3262,3262,390,50,39,89
3263,3263,248,60,54,114
3264,3264,208,20,74,94
3265,3265,7,18,43,61
3266,3266,215,58,118,176
3267,3267,236,57,112,169
3268,3268,419,37,36,73
3269,3269,441,58,56,114
3270,3270,365,39,74,113
3271,3271,333,57,40,97
3272,3272,11,16,94,110
3273,3273,257,24,29,53
3274,3274,95,52,84,136
3275,3275,75,16,63,79
3276,3276,113,14,71,85
3277,3277,21,18,117,135
3278,3278,14,47,119,166
3279,3279,90,21,97,118
3280,3280,353,28,107,135
3281,3281,448,29,40,69
3282,3282,297,58,57,115
3283,3283,39,41,26,67
3284,3284,354,11,33,44
3285,3285,40,10,106,116
3286,3286,203,17,23,40
3287,3287,411,49,76,125
3288,3288,39,30,108,138
3289,3289,286,45,37,82
3290,3290,340,44,46,90
3291,3291,389,16,116,132
3292,3292,223,12,100,112
3293,3293,378,12,26,38
3294,3294,470,32,67,99
3295,3295,392,12,73,85
3296,3296,107,12,109,121
3297,3297,295,44,114,158
3298,3298,351,22,99,121
3299,3299,231,27,108,135
3300,3300,403,13,41,54
3301,3301,320,38,19,57
3302,3302,106,14,118,132
3303,3303,52,17,80,97
3304,3304,138,29,57,86
3305,3305,124,10,37,47
3306,3306,349,30,67,97
3307,3307,423,48,58,106
3308,3308,226,38,77,115
3309,3309,283,59,53,112
3310,3310,99,55,107,162
3311,3311,275,15,52,67
3312,3312,429,10,58,68
3313,3313,440,51,104,155
3314,3314,374,36,36,72
3315,3315,343,26,61,87
3316,3316,169,19,38,57
3317,3317,410,51,30,81
3318,3318,293,42,115,157
3319,3319,182,22,53,75
3320,3320,466,39,49,88
3321,3321,286,25,40,65
3322,3322,368,38,86,124
3323,3323,178,50,95,145
3324,3324,385,56,90,146
3325,3325,297,16,85,101
3326,3326,265,40,95,135
3327,3327,50,44,78,122
3328,3328,206,26,57,83
3329,3329,7,31,110,141
3330,3330,8,54,26,80
3331,3331,282,56,98,154
3332,3332,438,19,109,128
3333,3333,39,30,89,119
3334,3334,450,42,49,91
3335,3335,390,10,81,91
3336,3336,235,34,109,143
3337,3337,161,12,60,72
3338,3338,44,26,111,137
3339,3339,33,40,119,159
3340,3340,479,53,98,151
3341,3341,66,60,21,81
3342,3342,351,35,43,78
3343,3343,441,51,51,102
3344,3344,143,29,52,81
3345,3345,221,55,67,122
3346,3346,9,35,68,103
3347,3347,41,41,83,124
3348,3348,435,32,37,69
3349,3349,124,19,33,52
3350,3350,234,20,77,97
3351,3351,19,41,53,94
3352,3352,253,33,87,120
3353,3353,86,33,30,63
3354,3354,266,57,118,175
3355,3355,308,52,90,142
3356,3356,44,51,30,81
3357,3357,206,39,56,95
3358,3358,257,17,108,125
3359,3359,218,11,108,119
3360,3360,28,20,100,120
3361,3361,346,33,115,148
3362,3362,445,37,100,137
3363,3363,353,56,62,118
3364,3364,63,15,28,43
3365,3365,269,49,70,119
3366,3366,207,30,31,61
3367,3367,152,55,79,134
3368,3368,298,15,119,134
3369,3369,447,21,85,106
3370,3370,313,56,38,94
3371,3371,34,53,71,124
3372,3372,356,55,27,82
3373,3373,408,20,50,70
3374,3374,54,27,109,136
3375,3375,96,31,93,124
3376,3376,312,60,58,118
3377,3377,80,38,56,94
3378,3378,41,27,100,127
3379,3379,199,35,68,103
3380,3380,308,21,49,70
3381,3381,117,55,115,170
3382,3382,365,24,109,133
3383,3383,32,42,76,118
3384,3384,363,27,117,144
3385,3385,32,19,41,60
3386,3386,423,43,67,110
3387,3387,40,46,37,83
3388,3388,158,40,20,60
3389,3389,75,34,95,129
3390,3390,313,31,55,86
3391,3391,243,60,45,105
3392,3392,191,25,102,127
3393,3393,163,26,38,64
3394,3394,142,48,39,87
3395,3395,335,15,50,65
3396,3396,346,30,61,91
3397,3397,281,28,112,140
3398,3398,272,54,112,166
3399,3399,479,24,59,83
3400,3400,306,14,46,60
3401,3401,449,36,22,58
3402,3402,71,41,50,91
3403,3403,188,32,25,57
3404,3404,371,58,31,89
3405,3405,412,21,27,48
3406,3406,16,38,100,138
3407,3407,159,10,79,89
3408,3408,317,12,52,64
3409,3409,199,22,23,45
3410,3410,249,19,83,102
3411,3411,297,23,111,134
3412,3412,290,34,113,147
3413,3413,167,58,45,103
3414,3414,183,28,34,62
3415,3415,164,29,113,142
3416,3416,359,35,26,61
3417,3417,276,13,32,45
3418,3418,362,24,84,108
3419,3419,234,18,48,66
3420,3420,261,31,30,61
3421,3421,448,22,113,135
3422,3422,422,12,51,63
3423,3423,351,18,36,54
3424,3424,294,52,62,114
3425,3425,308,48,64,112
3426,3426,15,48,76,124
3427,3427,292,23,43,66
3428,3428,48,14,102,116
3429,3429,430,28,114,142
3430,3430,416,13,74,87
3431,3431,80,14,48,62
3432,3432,148,32,116,148
3433,3433,397,53,68,121
3434,3434,311,42,83,125
3435,3435,276,47,20,67
3436,3436,167,33,22,55
3437,3437,372,16,96,112
3438,3438,362,21,41,62
3439,3439,135,37,51,88
3440,3440,362,41,89,130
3441,3441,62,40,64,104
3442,3442,166,34,24,58
3443,3443,470,30,80,110
3444,3444,198,27,116,143
3445,3445,21,39,33,72
3446,3446,264,41,18,59
3447,3447,80,39,81,120
3448,3448,431,10,32,42
3449,3449,342,54,98,152
3450,3450,369,37,38,75
3451,3451,380,29,23,52
3452,3452,403,35,109,144
3453,3453,155,26,73,99
3454,3454,409,39,52,91
3455,3455,270,10,83,93
3456,3456,286,40,75,115
3457,3457,427,34,99,133
3458,3458,324,24,72,96
3459,3459,275,21,55,76
3460,3460,427,18,96,114
3461,3461,251,30,55,85
3462,3462,474,34,31,65
3463,3463,270,27,17,44
3464,3464,453,45,26,71
3465,3465,432,26,110,136
3466,3466,14,27,64,91
3467,3467,460,34,45,79
3468,3468,56,50,41,91
3469,3469,95,52,106,158
3470,3470,211,50,49,99
3471,3471,97,50,19,69
3472,3472,232,41,117,158
3473,3473,476,18,52,70
3474,3474,175,10,69,79
3475,3475,270,58,111,169
3476,3476,479,42,97,139
3477,3477,171,34,83,117
3478,3478,280,20,26,46
3479,3479,313,40,38,78
3480,3480,139,41,15,56
3481,3481,65,11,67,78
3482,3482,73,56,78,134
3483,3483,189,17,108,125
3484,3484,195,17,32,49
3485,3485,111,59,23,82
3486,3486,233,15,120,135
3487,3487,236,29,65,94
3488,3488,136,53,86,139
3489,3489,79,40,106,146
3490,3490,243,10,98,108
3491,3491,354,37,54,91
3492,3492,296,17,101,118
3493,3493,401,51,97,148
3494,3494,15,40,49,89
3495,3495,372,43,74,117
3496,3496,158,36,84,120
3497,3497,454,43,109,152
3498,3498,376,53,19,72
3499,3499,387,14,99,113
3500,3500,337,19,113,132
3501,3501,231,26,119,145
3502,3502,355,38,47,85
3503,3503,406,31,23,54
3504,3504,40,25,48,73
3505,3505,288,16,84,100
3506,3506,111,54,110,164
3507,3507,191,13,94,107
3508,3508,381,25,103,128
3509,3509,146,59,79,138
3510,3510,339,44,46,90
3511,3511,161,21,72,93
3512,3512,403,41,53,94
3513,3513,182,22,90,112
3514,3514,267,54,109,163
3515,3515,298,23,60,83
3516,3516,362,57,52,109
3517,3517,21,60,66,126
3518,3518,299,30,44,74
3519,3519,383,14,69,83
3520,3520,411,14,53,67
3521,3521,381,29,54,83
3522,3522,403,50,84,134
3523,3523,105,46,73,119
3524,3524,266,30,89,119
3525,3525,136,31,60,91
3526,3526,92,50,75,125
3527,3527,272,38,64,102
3528,3528,123,15,95,110
3529,3529,195,29,62,91
3530,3530,55,55,114,169
3531,3531,466,48,114,162
3532,3532,345,45,16,61
3533,3533,426,24,59,83
3534,3534,31,55,37,92
3535,3535,350,41,89,130
3536,3536,212,28,70,98
3537,3537,148,22,20,42
3538,3538,428,31,91,122
3539,3539,116,18,39,57
3540,3540,180,49,96,145
3541,3541,72,16,27,43
3542,3542,318,30,103,133
3543,3543,189,59,87,146
3544,3544,356,51,50,101
3545,3545,371,35,81,116
3546,3546,314,59,73,132
3547,3547,133,31,49,80
3548,3548,321,45,28,73
3549,3549,215,15,28,43
3550,3550,133,40,115,155
3551,3551,383,46,103,149
3552,3552,341,43,118,161
3553,3553,164,17,34,51
3554,3554,267,60,112,172
3555,3555,183,17,24,41
3556,3556,436,49,119,168
3557,3557,147,27,69,96
3558,3558,258,15,94,109
3559,3559,192,38,55,93
3560,3560,181,34,120,154
3561,3561,299,39,101,140
3562,3562,390,36,34,70
3563,3563,76,22,103,125
3564,3564,168,39,57,96
3565,3565,326,37,101,138
3566,3566,439,41,58,99
3567,3567,135,30,101,131
3568,3568,340,42,80,122
3569,3569,327,51,109,160
3570,3570,474,29,106,135
3571,3571,428,32,116,148
3572,3572,383,52,38,90
3573,3573,132,16,51,67
3574,3574,98,32,106,138
3575,3575,105,22,116,138
3576,3576,181,39,46,85
3577,3577,146,39,42,81
3578,3578,92,58,79,137
3579,3579,143,26,67,93
3580,3580,407,25,118,143
3581,3581,371,34,61,95
3582,3582,250,17,72,89
3583,3583,372,49,70,119
3584,3584,327,34,119,153
3585,3585,49,40,62,102
3586,3586,169,31,58,89
3587,3587,194,35,81,116
3588,3588,421,42,81,123
3589,3589,447,28,50,78
3590,3590,401,30,60,90
3591,3591,467,21,53,74
3592,3592,392,44,90,134
3593,3593,336,43,110,153
3594,3594,89,31,99,130
3595,3595,48,42,113,155
3596,3596,5,25,18,43
3597,3597,117,23,94,117
3598,3598,444,16,74,90
3599,3599,433,47,92,139
3600,3600,253,22,52,74
3601,3601,284,35,38,73
3602,3602,479,43,76,119
3603,3603,103,33,15,48
3604,3604,209,16,16,32
3605,3605,88,32,86,118
3606,3606,86,42,38,80
3607,3607,468,20,114,134
3608,3608,16,47,100,147
3609,3609,346,53,105,158
3610,3610,360,53,47,100
3611,3611,438,19,87,106
3612,3612,202,30,30,60
3613,3613,231,28,49,77
3614,3614,192,32,83,115
3615,3615,10,36,44,80
3616,3616,481,45,108,153
3617,3617,364,46,21,67
3618,3618,323,58,36,94
3619,3619,304,55,70,125
3620,3620,255,23,32,55
3621,3621,162,12,65,77
3622,3622,457,14,73,87
3623,3623,222,30,51,81
3624,3624,206,59,108,167
3625,3625,181,38,31,69
3626,3626,167,59,86,145
3627,3627,330,55,118,173
3628,3628,271,47,15,62
3629,3629,172,34,81,115
3630,3630,178,15,107,122
3631,3631,233,38,88,126
3632,3632,182,34,40,74
3633,3633,227,33,109,142
3634,3634,63,46,62,108
3635,3635,9,44,25,69
3636,3636,289,23,41,64
3637,3637,308,37,78,115
3638,3638,54,47,53,100
3639,3639,362,59,67,126
3640,3640,472,58,63,121
3641,3641,118,44,120,164
3642,3642,416,55,55,110
3643,3643,54,51,22,73
3644,3644,61,48,93,141
3645,3645,436,12,113,125
3646,3646,3,35,119,154
3647,3647,455,48,18,66
3648,3648,418,41,59,100
3649,3649,128,39,113,152
3650,3650,11,58,16,74
3651,3651,89,32,31,63
3652,3652,426,53,48,101
3653,3653,163,28,115,143
3654,3654,28,48,55,103
3655,3655,306,17,58,75
3656,3656,405,58,41,99
3657,3657,460,33,31,64
3658,3658,19,55,17,72
3659,3659,121,13,24,37
3660,3660,323,58,88,146
3661,3661,8,43,70,113
3662,3662,369,22,48,70
3663,3663,139,22,107,129
3664,3664,92,48,108,156
3665,3665,295,41,70,111
3666,3666,259,51,117,168
3667,3667,175,19,112,131
3668,3668,295,14,55,69
3669,3669,101,37,73,110
3670,3670,275,44,88,132
3671,3671,212,47,64,111
3672,3672,388,38,56,94
3673,3673,293,31,100,131
3674,3674,292,10,15,25
3675,3675,111,56,43,99
3676,3676,354,22,27,49
3677,3677,231,51,97,148
3678,3678,34,34,118,152
3679,3679,207,19,99,118
3680,3680,401,10,107,117
3681,3681,164,45,38,83
3682,3682,403,59,71,130
3683,3683,374,24,115,139
3684,3684,361,20,58,78
3685,3685,164,26,84,110
3686,3686,280,27,94,121
3687,3687,355,33,18,51
3688,3688,343,53,77,130
3689,3689,444,54,96,150
3690,3690,118,39,98,137
3691,3691,2,21,48,69
3692,3692,350,13,15,28
3693,3693,425,31,73,104
3694,3694,137,16,113,129
3695,3695,376,10,22,32
3696,3696,137,40,112,152
3697,3697,439,38,54,92
3698,3698,176,21,67,88
3699,3699,144,27,103,130
3700,3700,36,28,74,102
3701,3701,379,13,65,78
3702,3702,298,22,107,129
3703,3703,26,17,40,57
3704,3704,103,28,96,124
3705,3705,95,13,115,128
3706,3706,388,23,62,85
3707,3707,376,23,90,113
3708,3708,180,15,88,103
3709,3709,33,39,39,78
3710,3710,294,50,107,157
3711,3711,274,34,24,58
3712,3712,458,48,109,157
3713,3713,164,27,82,109
3714,3714,386,30,23,53
3715,3715,462,26,47,73
3716,3716,224,33,46,79
3717,3717,430,32,113,145
3718,3718,303,39,113,152
3719,3719,176,10,42,52
3720,3720,300,39,58,97
3721,3721,52,35,50,85
3722,3722,214,25,54,79
3723,3723,211,30,29,59
3724,3724,195,60,78,138
3725,3725,357,51,71,122
3726,3726,414,34,113,147
3727,3727,467,24,72,96
3728,3728,423,36,21,57
3729,3729,347,39,82,121
3730,3730,51,42,120,162
3731,3731,7,25,16,41
3732,3732,123,55,77,132
3733,3733,289,13,108,121
3734,3734,262,24,18,42
3735,3735,364,23,120,143
3736,3736,322,16,78,94
3737,3737,258,60,62,122
3738,3738,80,35,91,126
3739,3739,389,35,106,141
3740,3740,281,25,86,111
3741,3741,90,16,88,104
3742,3742,41,43,119,162
3743,3743,242,58,43,101
3744,3744,420,53,34,87
3745,3745,452,57,24,81
3746,3746,318,52,45,97
3747,3747,128,29,46,75
3748,3748,96,48,102,150
3749,3749,25,59,113,172
3750,3750,337,11,17,28
3751,3751,394,15,98,113
3752,3752,259,51,18,69
3753,3753,422,52,94,146
3754,3754,335,18,69,87
3755,3755,69,37,28,65
3756,3756,142,49,99,148
3757,3757,197,25,74,99
3758,3758,289,41,31,72
3759,3759,243,36,94,130
3760,3760,240,57,78,135
3761,3761,456,55,91,146
3762,3762,342,59,46,105
3763,3763,430,37,108,145
3764,3764,61,36,113,149
3765,3765,225,26,84,110
3766,3766,125,21,108,129
3767,3767,64,11,80,91
3768,3768,227,39,119,158
3769,3769,403,20,52,72
3770,3770,109,47,94,141
3771,3771,163,29,29,58
3772,3772,230,48,56,104
3773,3773,242,52,78,130
3774,3774,399,23,60,83
3775,3775,296,56,48,104
3776,3776,86,46,110,156
3777,3777,293,21,97,118
3778,3778,422,28,35,63
3779,3779,245,16,29,45
3780,3780,273,42,90,132
3781,3781,144,17,113,130
3782,3782,467,19,81,100
3783,3783,257,30,58,88
3784,3784,72,44,91,135
3785,3785,24,47,72,119
3786,3786,220,55,27,82
3787,3787,87,53,38,91
3788,3788,247,29,95,124
3789,3789,35,19,91,110
3790,3790,391,48,62,110
3791,3791,270,43,72,115
3792,3792,91,34,43,77
3793,3793,453,11,17,28
3794,3794,83,16,85,101
3795,3795,186,44,82,126
3796,3796,124,10,27,37
3797,3797,135,52,32,84
3798,3798,127,21,87,108
3799,3799,451,21,86,107
3800,3800,462,20,85,105
3801,3801,243,50,120,170
3802,3802,469,59,115,174
3803,3803,390,54,109,163
3804,3804,298,31,89,120
3805,3805,263,18,59,77
3806,3806,192,24,20,44
3807,3807,441,11,40,51
3808,3808,130,14,113,127
3809,3809,83,35,64,99
3810,3810,430,49,64,113
3811,3811,391,58,42,100
3812,3812,61,32,82,114
3813,3813,103,17,103,120
3814,3814,19,50,76,126
3815,3815,323,39,28,67
3816,3816,102,25,115,140
3817,3817,346,15,43,58
3818,3818,381,31,118,149
3819,3819,466,20,26,46
3820,3820,1,51,65,116
3821,3821,333,36,89,125
3822,3822,333,48,59,107
3823,3823,370,55,48,103
3824,3824,462,11,39,50
3825,3825,223,21,31,52
3826,3826,386,34,120,154
3827,3827,64,16,94,110
3828,3828,353,34,105,139
3829,3829,330,15,60,75
3830,3830,138,12,44,56
3831,3831,345,19,91,110
3832,3832,92,42,104,146
3833,3833,424,59,29,88
3834,3834,36,52,112,164
3835,3835,141,51,87,138
3836,3836,200,11,53,64
3837,3837,48,19,34,53
3838,3838,313,30,27,57
3839,3839,430,45,115,160
3840,3840,398,22,62,84
3841,3841,433,17,72,89
3842,3842,90,12,33,45
3843,3843,413,50,64,114
3844,3844,184,19,57,76
3845,3845,340,22,83,105
3846,3846,20,38,104,142
3847,3847,346,20,51,71
3848,3848,297,57,106,163
3849,3849,130,40,36,76
3850,3850,304,52,92,144
3851,3851,261,29,28,57
3852,3852,95,38,36,74
3853,3853,360,23,93,116
3854,3854,225,43,82,125
3855,3855,258,19,20,39
3856,3856,90,31,100,131
3857,3857,353,39,98,137
3858,3858,290,51,54,105
3859,3859,246,29,91,120
3860,3860,445,54,26,80
3861,3861,70,17,102,119
3862,3862,138,40,114,154
3863,3863,96,29,34,63
3864,3864,220,60,31,91
3865,3865,459,49,30,79
3866,3866,195,35,54,89
3867,3867,289,12,47,59
3868,3868,187,22,39,61
3869,3869,41,57,37,94
3870,3870,1,19,70,89
3871,3871,366,25,109,134
3872,3872,97,33,18,51
3873,3873,274,30,111,141
3874,3874,138,10,88,98
3875,3875,208,12,24,36
3876,3876,226,40,61,101
3877,3877,259,27,85,112
3878,3878,112,15,82,97
3879,3879,435,60,47,107
3880,3880,152,27,54,81
3881,3881,198,52,97,149
3882,3882,477,46,22,68
3883,3883,352,32,58,90
3884,3884,313,23,28,51
3885,3885,394,45,98,143
3886,3886,64,48,28,76
3887,3887,157,60,97,157
3888,3888,83,59,18,77
3889,3889,8,51,106,157
3890,3890,28,20,68,88
3891,3891,12,51,90,141
3892,3892,32,42,81,123
3893,3893,27,57,115,172
3894,3894,396,31,29,60
3895,3895,140,14,87,101
3896,3896,245,56,43,99
3897,3897,391,43,87,130
3898,3898,4,29,48,77
3899,3899,58,58,29,87
3900,3900,173,52,104,156
3901,3901,19,12,75,87
3902,3902,42,22,58,80
3903,3903,357,28,113,141
3904,3904,398,24,108,132
3905,3905,403,22,98,120
3906,3906,351,38,17,55
3907,3907,174,45,35,80
3908,3908,74,52,25,77
3909,3909,419,58,29,87
3910,3910,209,21,103,124
3911,3911,470,52,59,111
3912,3912,448,54,104,158
3913,3913,382,51,40,91
3914,3914,204,19,45,64
3915,3915,108,19,87,106
3916,3916,222,54,102,156
3917,3917,107,10,96,106
3918,3918,441,33,36,69
3919,3919,348,35,55,90
3920,3920,295,46,23,69
3921,3921,306,48,74,122
3922,3922,34,54,116,170
3923,3923,73,53,16,69
3924,3924,326,57,24,81
3925,3925,147,57,39,96
3926,3926,232,22,47,69
3927,3927,110,22,41,63
3928,3928,291,26,102,128
3929,3929,338,57,17,74
3930,3930,456,24,119,143
3931,3931,21,43,110,153
3932,3932,264,41,85,126
3933,3933,100,54,42,96
3934,3934,350,20,65,85
3935,3935,113,12,101,113
3936,3936,248,47,84,131
3937,3937,40,44,76,120
3938,3938,396,52,23,75
3939,3939,339,56,82,138
3940,3940,190,24,105,129
3941,3941,405,27,68,95
3942,3942,332,11,84,95
3943,3943,338,42,19,61
3944,3944,88,54,36,90
3945,3945,382,41,72,113
3946,3946,314,40,76,116
3947,3947,62,57,26,83
3948,3948,435,35,37,72
3949,3949,324,38,75,113
3950,3950,392,52,78,130
3951,3951,11,13,89,102
3952,3952,76,57,59,116
3953,3953,390,47,67,114
3954,3954,143,23,38,61
3955,3955,316,14,99,113
3956,3956,342,48,77,125
3957,3957,254,11,50,61
3958,3958,345,42,28,70
3959,3959,283,50,48,98
3960,3960,467,23,77,100
3961,3961,259,51,70,121
3962,3962,364,46,48,94
3963,3963,402,13,103,116
3964,3964,422,26,35,61
3965,3965,291,40,25,65
3966,3966,397,40,42,82
3967,3967,186,18,29,47
3968,3968,297,17,35,52
3969,3969,80,53,66,119
3970,3970,139,20,105,125
3971,3971,280,29,72,101
3972,3972,106,46,66,112
3973,3973,359,25,76,101
3974,3974,381,35,66,101
3975,3975,453,52,39,91
3976,3976,323,16,72,88
3977,3977,38,44,16,60
3978,3978,463,13,15,28
3979,3979,364,18,52,70
3980,3980,185,53,42,95
3981,3981,61,39,70,109
3982,3982,481,40,30,70
3983,3983,319,28,25,53
3984,3984,24,46,98,144
3985,3985,467,49,87,136
3986,3986,441,32,29,61
3987,3987,399,51,115,166
3988,3988,329,60,20,80
3989,3989,141,58,67,125
3990,3990,450,31,70,101
3991,3991,392,56,61,117
3992,3992,255,18,44,62
3993,3993,406,35,31,66
3994,3994,267,43,44,87
3995,3995,413,54,83,137
3996,3996,174,27,21,48
3997,3997,413,31,93,124
3998,3998,379,31,40,71
3999,3999,4,25,86,111
4000,4000,456,25,28,53
4001,4001,187,35,43,78
4002,4002,257,59,43,102
4003,4003,167,32,36,68
4004,4004,284,53,31,84
4005,4005,38,51,64,115
4006,4006,454,18,65,83
4007,4007,106,16,74,90
4008,4008,286,59,99,158
4009,4009,12,37,81,118
4010,4010,204,34,86,120
4011,4011,254,23,112,135
4012,4012,333,53,94,147
4013,4013,123,54,103,157
4014,4014,184,41,43,84
4015,4015,371,44,34,78
4016,4016,453,11,92,103
4017,4017,477,18,36,54
4018,4018,125,57,101,158
4019,4019,231,16,81,97
4020,4020,139,34,103,137
4021,4021,473,28,42,70
4022,4022,417,54,104,158
4023,4023,428,25,40,65
4024,4024,288,36,43,79
4025,4025,213,58,118,176
4026,4026,188,42,50,92
4027,4027,16,40,115,155
4028,4028,365,58,65,123
4029,4029,255,29,62,91
4030,4030,350,22,58,80
4031,4031,129,39,108,147
4032,4032,433,21,67,88
4033,4033,389,15,63,78
4034,4034,306,32,105,137
4035,4035,113,22,110,132
4036,4036,109,15,120,135
4037,4037,361,54,24,78
4038,4038,260,56,97,153
4039,4039,110,10,105,115
4040,4040,245,40,96,136
4041,4041,251,29,25,54
4042,4042,399,27,78,105
4043,4043,369,27,65,92
4044,4044,457,37,114,151
4045,4045,130,40,30,70
4046,4046,50,25,68,93
4047,4047,267,41,107,148
4048,4048,90,34,87,121
4049,4049,333,50,99,149
4050,4050,94,24,28,52
4051,4051,341,48,25,73
4052,4052,322,49,27,76
4053,4053,456,42,57,99
4054,4054,158,19,106,125
4055,4055,453,49,38,87
4056,4056,283,27,97,124
4057,4057,133,10,34,44
4058,4058,95,28,31,59
4059,4059,53,46,45,91
4060,4060,275,55,24,79
4061,4061,346,18,18,36
4062,4062,339,37,19,56
4063,4063,150,51,23,74
4064,4064,77,10,75,85
4065,4065,459,57,71,128
4066,4066,14,50,67,117
4067,4067,193,41,64,105
4068,4068,92,59,95,154
4069,4069,207,12,78,90
4070,4070,65,29,17,46
4071,4071,304,28,116,144
4072,4072,162,51,93,144
4073,4073,289,25,106,131
4074,4074,26,52,45,97
4075,4075,471,58,77,135
4076,4076,420,44,95,139
4077,4077,29,60,59,119
4078,4078,113,15,96,111
4079,4079,64,12,97,109
4080,4080,122,45,95,140
4081,4081,117,23,21,44
4082,4082,46,55,39,94
4083,4083,308,12,94,106
4084,4084,375,36,90,126
4085,4085,208,22,66,88
4086,4086,423,44,40,84
4087,4087,189,22,104,126
4088,4088,56,55,67,122
4089,4089,441,25,22,47
4090,4090,225,14,42,56
4091,4091,304,46,105,151
4092,4092,241,34,31,65
4093,4093,400,44,38,82
4094,4094,22,25,49,74
4095,4095,5,16,86,102
4096,4096,275,26,77,103
4097,4097,59,43,93,136
4098,4098,87,17,101,118
4099,4099,463,17,40,57
4100,4100,214,29,39,68
4101,4101,190,60,77,137
4102,4102,158,51,101,152
4103,4103,401,31,75,106
4104,4104,133,53,60,113
4105,4105,71,36,104,140
4106,4106,380,55,82,137
4107,4107,352,25,49,74
4108,4108,176,17,52,69
4109,4109,139,32,107,139
4110,4110,386,43,29,72
4111,4111,387,36,115,151
4112,4112,476,10,43,53
4113,4113,478,22,20,42
4114,4114,2,60,43,103
4115,4115,22,35,55,90
4116,4116,165,20,81,101
4117,4117,18,20,34,54
4118,4118,208,18,18,36
4119,4119,345,60,16,76
4120,4120,309,57,84,141
4121,4121,284,26,112,138
4122,4122,158,17,99,116
4123,4123,328,20,49,69
4124,4124,11,41,96,137
4125,4125,384,16,105,121
4126,4126,428,16,50,66
4127,4127,299,27,38,65
4128,4128,10,40,32,72
4129,4129,382,52,119,171
4130,4130,397,20,74,94
4131,4131,104,14,69,83
4132,4132,399,23,30,53
4133,4133,193,56,116,172
4134,4134,191,21,70,91
4135,4135,118,47,84,131
4136,4136,72,58,15,73
4137,4137,188,34,78,112
4138,4138,275,13,49,62
4139,4139,148,38,67,105
4140,4140,4,35,28,63
4141,4141,455,60,17,77
4142,4142,218,16,101,117
4143,4143,372,17,75,92
4144,4144,457,44,118,162
4145,4145,468,54,118,172
4146,4146,355,58,116,174
4147,4147,43,27,79,106
4148,4148,473,29,89,118
4149,4149,382,47,66,113
4150,4150,351,10,53,63
4151,4151,281,25,78,103
4152,4152,216,12,104,116
4153,4153,468,49,57,106
4154,4154,262,47,111,158
4155,4155,115,45,67,112
4156,4156,417,10,71,81
4157,4157,260,29,25,54
4158,4158,295,48,43,91
4159,4159,246,33,27,60
4160,4160,331,44,85,129
4161,4161,127,28,89,117
4162,4162,260,53,112,165
4163,4163,443,42,43,85
4164,4164,270,26,40,66
4165,4165,261,29,118,147
4166,4166,315,11,22,33
4167,4167,183,58,44,102
4168,4168,461,31,47,78
4169,4169,44,34,118,152
4170,4170,340,60,112,172
4171,4171,301,59,47,106
4172,4172,107,17,74,91
4173,4173,26,12,78,90
4174,4174,49,58,63,121
4175,4175,37,12,96,108
4176,4176,232,40,93,133
4177,4177,363,17,30,47
4178,4178,69,36,83,119
4179,4179,132,15,39,54
4180,4180,391,22,88,110
4181,4181,401,46,84,130
4182,4182,460,25,118,143
4183,4183,107,11,117,128
4184,4184,334,58,112,170
4185,4185,233,15,32,47
4186,4186,358,41,75,116
4187,4187,389,60,113,173
4188,4188,42,47,113,160
4189,4189,268,13,112,125
4190,4190,113,40,94,134
4191,4191,146,57,96,153
4192,4192,451,39,15,54
4193,4193,124,13,103,116
4194,4194,480,38,20,58
4195,4195,181,49,97,146
4196,4196,266,12,119,131
4197,4197,282,17,111,128
4198,4198,348,50,94,144
4199,4199,219,45,22,67
4200,4200,253,36,44,80
4201,4201,415,10,82,92
4202,4202,472,49,54,103
4203,4203,141,24,26,50
4204,4204,196,17,115,132
4205,4205,456,18,115,133
4206,4206,159,48,108,156
4207,4207,451,43,56,99
4208,4208,30,27,62,89
4209,4209,260,54,59,113
4210,4210,59,56,69,125
4211,4211,30,45,27,72
4212,4212,312,27,117,144
4213,4213,40,57,88,145
4214,4214,102,35,102,137
4215,4215,104,25,80,105
4216,4216,137,56,64,120
4217,4217,52,26,118,144
4218,4218,456,12,32,44
4219,4219,214,51,117,168
4220,4220,339,51,67,118
4221,4221,427,50,100,150
4222,4222,85,44,115,159
4223,4223,354,10,39,49
4224,4224,356,53,51,104
4225,4225,3,27,72,99
4226,4226,161,19,49,68
4227,4227,335,42,49,91
4228,4228,25,41,102,143
4229,4229,196,22,100,122
4230,4230,196,45,21,66
4231,4231,440,42,39,81
4232,4232,451,20,120,140
4233,4233,9,59,79,138
4234,4234,177,42,115,157
4235,4235,152,37,52,89
4236,4236,246,31,112,143
4237,4237,137,56,29,85
4238,4238,411,21,90,111
4239,4239,409,12,72,84
4240,4240,116,17,35,52
4241,4241,242,37,29,66
4242,4242,80,18,34,52
4243,4243,136,42,24,66
4244,4244,190,54,106,160
4245,4245,119,59,71,130
4246,4246,78,54,119,173
4247,4247,414,43,63,106
4248,4248,238,10,75,85
4249,4249,322,12,43,55
4250,4250,225,32,23,55
4251,4251,202,14,61,75
4252,4252,234,46,25,71
4253,4253,450,25,98,123
4254,4254,140,47,89,136
4255,4255,66,53,64,117
4256,4256,473,18,120,138
4257,4257,131,29,50,79
4258,4258,267,15,120,135
4259,4259,132,17,119,136
4260,4260,286,14,69,83
4261,4261,280,55,73,128
4262,4262,185,17,43,60
4263,4263,432,12,20,32
4264,4264,10,10,17,27
4265,4265,180,21,25,46
4266,4266,461,50,87,137
4267,4267,72,55,40,95
4268,4268,182,32,98,130
4269,4269,272,17,35,52
4270,4270,241,39,108,147
4271,4271,88,10,22,32
4272,4272,349,35,118,153
4273,4273,116,42,48,90
4274,4274,338,30,41,71
4275,4275,373,35,27,62
4276,4276,400,21,94,115
4277,4277,263,55,36,91
4278,4278,152,41,20,61
4279,4279,437,15,93,108
4280,4280,280,18,91,109
4281,4281,294,40,38,78
4282,4282,352,31,81,112
4283,4283,31,21,49,70
4284,4284,326,37,119,156
4285,4285,302,36,88,124
4286,4286,429,16,102,118
4287,4287,221,57,79,136
4288,4288,466,45,105,150
4289,4289,237,40,101,141
4290,4290,94,40,89,129
4291,4291,400,34,51,85
4292,4292,395,31,112,143
4293,4293,134,37,90,127
4294,4294,348,57,60,117
4295,4295,390,35,84,119
4296,4296,162,28,32,60
4297,4297,455,55,83,138
4298,4298,466,20,52,72
4299,4299,103,45,81,126
4300,4300,404,22,65,87
4301,4301,435,24,19,43
4302,4302,332,21,44,65
4303,4303,313,11,42,53
4304,4304,69,38,76,114
4305,4305,245,35,112,147
4306,4306,179,35,31,66
4307,4307,113,36,120,156
4308,4308,17,51,25,76
4309,4309,200,45,93,138
4310,4310,468,32,29,61
4311,4311,101,60,90,150
4312,4312,387,39,102,141
4313,4313,63,49,31,80
4314,4314,421,12,44,56
4315,4315,268,50,60,110
4316,4316,389,24,93,117
4317,4317,45,30,107,137
4318,4318,155,40,18,58
4319,4319,266,46,28,74
4320,4320,143,42,110,152
4321,4321,93,33,15,48
4322,4322,358,49,71,120
4323,4323,464,37,118,155
4324,4324,269,60,19,79
4325,4325,286,35,34,69
4326,4326,254,20,86,106
4327,4327,299,60,117,177
4328,4328,40,22,55,77
4329,4329,321,11,116,127
4330,4330,39,54,98,152
4331,4331,172,47,68,115
4332,4332,188,16,15,31
4333,4333,133,40,120,160
4334,4334,355,49,76,125
4335,4335,90,26,38,64
4336,4336,416,29,107,136
4337,4337,313,44,117,161
4338,4338,45,21,86,107
4339,4339,108,31,41,72
4340,4340,400,26,79,105
4341,4341,154,48,22,70
4342,4342,169,13,96,109
4343,4343,370,21,66,87
4344,4344,165,11,115,126
4345,4345,19,35,19,54
4346,4346,462,44,106,150
4347,4347,214,56,75,131
4348,4348,391,10,108,118
4349,4349,305,13,118,131
4350,4350,223,32,82,114
4351,4351,122,55,86,141
4352,4352,103,30,18,48
4353,4353,398,31,27,58
4354,4354,342,28,43,71
4355,4355,131,48,52,100
4356,4356,463,13,94,107
4357,4357,148,47,100,147
4358,4358,412,39,25,64
4359,4359,147,16,55,71
4360,4360,38,13,52,65
4361,4361,385,15,87,102
4362,4362,19,51,61,112
4363,4363,200,48,58,106
4364,4364,458,52,88,140
4365,4365,147,10,101,111
4366,4366,346,28,86,114
4367,4367,273,23,31,54
4368,4368,302,24,46,70
4369,4369,46,23,40,63
4370,4370,21,21,75,96
4371,4371,409,29,31,60
4372,4372,117,45,105,150
4373,4373,326,52,89,141
4374,4374,422,39,90,129
4375,4375,175,29,74,103
4376,4376,6,53,35,88
4377,4377,413,30,29,59
4378,4378,401,23,111,134
4379,4379,440,48,83,131
4380,4380,108,25,105,130
4381,4381,182,47,110,157
4382,4382,443,22,67,89
4383,4383,348,46,59,105
4384,4384,273,59,118,177
4385,4385,461,20,79,99
4386,4386,116,12,103,115
4387,4387,45,21,80,101
4388,4388,115,33,44,77
4389,4389,5,54,29,83
4390,4390,1,50,57,107
4391,4391,1,42,45,87
4392,4392,66,24,47,71
4393,4393,254,56,49,105
4394,4394,232,17,39,56
4395,4395,357,37,65,102
4396,4396,7,25,30,55
4397,4397,150,18,39,57
4398,4398,171,60,47,107
4399,4399,71,52,37,89
4400,4400,470,32,82,114
4401,4401,468,32,36,68
4402,4402,328,22,120,142
4403,4403,198,13,89,102
4404,4404,418,15,15,30
4405,4405,25,36,48,84
4406,4406,149,49,24,73
4407,4407,298,36,90,126
4408,4408,87,42,62,104
4409,4409,223,14,112,126
4410,4410,262,33,22,55
4411,4411,231,31,39,70
4412,4412,201,40,72,112
4413,4413,278,11,119,130
4414,4414,300,27,91,118
4415,4415,3,25,77,102
4416,4416,410,12,20,32
4417,4417,332,27,36,63
4418,4418,3,44,110,154
4419,4419,249,10,92,102
4420,4420,109,59,104,163
4421,4421,150,31,106,137
4422,4422,447,59,65,124
4423,4423,52,38,118,156
4424,4424,480,51,114,165
4425,4425,222,15,76,91
4426,4426,132,22,43,65
4427,4427,227,43,21,64
4428,4428,200,51,106,157
4429,4429,48,27,51,78
4430,4430,400,52,114,166
4431,4431,234,37,84,121
4432,4432,258,54,52,106
4433,4433,472,26,52,78
4434,4434,254,11,92,103
4435,4435,351,51,98,149
4436,4436,48,23,66,89
4437,4437,352,58,71,129
4438,4438,88,31,42,73
4439,4439,427,23,27,50
4440,4440,431,36,89,125
4441,4441,450,22,72,94
4442,4442,199,48,39,87
4443,4443,53,33,25,58
4444,4444,462,32,56,88
4445,4445,92,60,23,83
4446,4446,114,51,27,78
4447,4447,170,41,97,138
4448,4448,103,41,38,79
4449,4449,260,25,106,131
4450,4450,224,60,29,89
4451,4451,324,13,23,36
4452,4452,28,28,16,44
4453,4453,428,28,23,51
4454,4454,74,39,76,115
4455,4455,390,10,114,124
4456,4456,366,36,47,83
4457,4457,315,46,81,127
4458,4458,188,43,23,66
4459,4459,42,13,90,103
4460,4460,393,24,108,132
4461,4461,391,23,73,96
4462,4462,267,22,29,51
4463,4463,165,41,79,120
4464,4464,435,19,27,46
4465,4465,267,32,80,112
4466,4466,22,23,56,79
4467,4467,444,43,101,144
4468,4468,362,49,79,128
4469,4469,372,45,86,131
4470,4470,441,47,47,94
4471,4471,168,13,83,96
4472,4472,137,44,31,75
4473,4473,6,36,74,110
4474,4474,300,35,102,137
4475,4475,264,24,92,116
4476,4476,436,19,90,109
4477,4477,29,14,97,111
4478,4478,467,42,19,61
4479,4479,368,39,107,146
4480,4480,283,40,95,135
4481,4481,152,14,36,50
4482,4482,370,48,91,139
4483,4483,136,37,113,150
4484,4484,29,45,109,154
4485,4485,400,40,95,135
4486,4486,129,15,105,120
4487,4487,344,24,15,39
4488,4488,377,50,103,153
4489,4489,5,37,29,66
4490,4490,479,23,94,117
4491,4491,52,59,92,151
4492,4492,419,18,107,125
4493,4493,388,39,92,131
4494,4494,189,22,79,101
4495,4495,44,16,30,46
4496,4496,435,50,71,121
4497,4497,333,38,89,127
4498,4498,215,11,27,38
4499,4499,347,28,90,118
4500,4500,82,33,61,94
4501,4501,131,28,16,44
4502,4502,263,10,76,86
4503,4503,354,26,24,50
4504,4504,89,45,59,104
4505,4505,105,20,60,80
4506,4506,321,44,88,132
4507,4507,116,31,25,56
4508,4508,468,59,21,80
4509,4509,317,56,52,108
4510,4510,255,48,82,130
4511,4511,100,22,70,92
4512,4512,474,34,46,80
4513,4513,36,32,81,113
4514,4514,101,45,92,137
4515,4515,393,10,31,41
4516,4516,236,25,52,77
4517,4517,266,22,68,90
4518,4518,52,22,17,39
4519,4519,435,48,72,120
4520,4520,399,44,16,60
4521,4521,319,16,114,130
4522,4522,87,44,99,143
4523,4523,443,35,66,101
4524,4524,389,57,24,81
4525,4525,376,45,46,91
4526,4526,118,38,78,116
4527,4527,2,33,70,103
4528,4528,323,10,70,80
4529,4529,91,16,52,68
4530,4530,389,35,102,137
4531,4531,97,31,99,130
4532,4532,433,21,74,95
4533,4533,172,24,55,79
4534,4534,234,29,70,99
4535,4535,470,54,47,101
4536,4536,30,33,83,116
4537,4537,307,56,43,99
4538,4538,81,21,68,89
4539,4539,373,28,53,81
4540,4540,288,55,107,162
4541,4541,108,16,111,127
4542,4542,363,20,21,41
4543,4543,291,20,89,109
4544,4544,61,56,42,98
4545,4545,113,24,49,73
4546,4546,297,34,80,114
4547,4547,182,19,63,82
4548,4548,240,54,100,154
4549,4549,176,52,103,155
4550,4550,81,44,25,69
4551,4551,92,18,71,89
4552,4552,84,60,110,170
4553,4553,127,11,65,76
4554,4554,246,39,52,91
4555,4555,353,38,43,81
4556,4556,233,21,42,63
4557,4557,436,11,44,55
4558,4558,291,34,16,50
4559,4559,35,58,44,102
4560,4560,387,44,114,158
4561,4561,66,55,78,133
4562,4562,147,50,18,68
4563,4563,334,49,101,150
4564,4564,268,18,50,68
4565,4565,461,31,90,121
4566,4566,315,31,73,104
4567,4567,389,12,86,98
4568,4568,231,59,64,123
4569,4569,283,31,53,84
4570,4570,348,13,18,31
4571,4571,315,20,66,86
4572,4572,80,57,21,78
4573,4573,146,38,35,73
4574,4574,54,50,66,116
4575,4575,121,28,60,88
4576,4576,15,52,69,121
4577,4577,150,52,18,70
4578,4578,473,54,75,129
4579,4579,248,14,37,51
4580,4580,89,39,39,78
4581,4581,275,49,31,80
4582,4582,261,12,26,38
4583,4583,245,48,36,84
4584,4584,244,33,89,122
4585,4585,342,48,98,146
4586,4586,355,13,119,132
4587,4587,237,46,73,119
4588,4588,405,39,114,153
4589,4589,13,57,51,108
4590,4590,369,20,44,64
4591,4591,434,17,37,54
4592,4592,149,34,85,119
4593,4593,151,37,104,141
4594,4594,323,22,35,57
4595,4595,28,36,63,99
4596,4596,237,50,42,92
4597,4597,147,58,119,177
4598,4598,50,58,30,88
4599,4599,72,47,67,114
4600,4600,72,23,105,128
4601,4601,66,32,37,69
4602,4602,375,15,108,123
4603,4603,278,44,98,142
4604,4604,211,50,118,168
4605,4605,104,32,57,89
4606,4606,12,41,17,58
4607,4607,417,49,92,141
4608,4608,405,42,65,107
4609,4609,375,32,70,102
4610,4610,435,14,87,101
4611,4611,32,34,97,131
4612,4612,411,43,80,123
4613,4613,189,13,89,102
4614,4614,317,31,54,85
4615,4615,133,44,86,130
4616,4616,205,37,89,126
4617,4617,209,52,96,148
4618,4618,131,42,118,160
4619,4619,401,10,118,128
4620,4620,151,57,36,93
4621,4621,392,38,72,110
4622,4622,371,37,117,154
4623,4623,238,43,43,86
4624,4624,395,60,87,147
4625,4625,279,55,17,72
4626,4626,157,52,28,80
4627,4627,185,59,59,118
4628,4628,371,30,106,136
4629,4629,285,16,49,65
4630,4630,231,14,118,132
4631,4631,442,11,111,122
4632,4632,15,54,73,127
4633,4633,69,30,25,55
4634,4634,262,30,39,69
4635,4635,126,57,72,129
4636,4636,110,20,20,40
4637,4637,159,57,28,85
4638,4638,226,49,81,130
4639,4639,35,19,16,35
4640,4640,315,12,60,72
4641,4641,215,48,57,105
4642,4642,164,11,34,45
4643,4643,158,20,87,107
4644,4644,232,32,59,91
4645,4645,199,55,117,172
4646,4646,413,56,85,141
4647,4647,282,38,50,88
4648,4648,278,55,111,166
4649,4649,249,26,38,64
4650,4650,309,14,96,110
4651,4651,172,13,97,110
4652,4652,283,43,104,147
4653,4653,294,15,120,135
4654,4654,340,46,102,148
4655,4655,406,47,96,143
4656,4656,8,55,46,101
4657,4657,102,36,71,107
4658,4658,395,35,103,138
4659,4659,37,27,120,147
4660,4660,175,29,68,97
4661,4661,338,47,31,78
4662,4662,184,25,106,131
4663,4663,15,14,107,121
4664,4664,156,26,107,133
4665,4665,206,37,99,136
4666,4666,63,49,54,103
4667,4667,11,38,15,53
4668,4668,219,40,111,151
4669,4669,132,58,55,113
4670,4670,50,22,79,101
4671,4671,107,52,87,139
4672,4672,326,59,42,101
4673,4673,193,40,21,61
4674,4674,198,14,110,124
4675,4675,145,19,112,131
4676,4676,374,31,66,97
4677,4677,401,54,47,101
4678,4678,222,12,78,90
4679,4679,17,54,120,174
4680,4680,388,31,100,131
4681,4681,283,29,71,100
4682,4682,316,47,78,125
4683,4683,110,12,42,54
4684,4684,466,27,107,134
4685,4685,34,18,62,80
4686,4686,263,11,61,72
4687,4687,60,12,17,29
4688,4688,35,31,22,53
4689,4689,144,23,101,124
4690,4690,36,10,51,61
4691,4691,305,34,112,146
4692,4692,36,27,119,146
4693,4693,90,40,43,83
4694,4694,438,11,109,120
4695,4695,293,11,99,110
4696,4696,242,21,84,105
4697,4697,398,20,49,69
4698,4698,411,18,91,109
4699,4699,105,16,51,67
4700,4700,75,10,71,81
4701,4701,37,40,112,152
4702,4702,316,33,16,49
4703,4703,411,55,56,111
4704,4704,61,55,56,111
4705,4705,381,36,45,81
4706,4706,147,51,107,158
4707,4707,381,10,58,68
4708,4708,184,14,71,85
4709,4709,100,42,106,148
4710,4710,54,29,60,89
4711,4711,362,42,43,85
4712,4712,14,16,80,96
4713,4713,351,50,102,152
4714,4714,331,18,98,116
4715,4715,219,27,63,90
4716,4716,195,31,17,48
4717,4717,340,23,87,110
4718,4718,241,10,107,117
4719,4719,141,43,73,116
4720,4720,171,35,86,121
4721,4721,105,22,107,129
4722,4722,223,56,75,131
4723,4723,443,55,101,156
4724,4724,139,28,29,57
4725,4725,398,50,60,110
4726,4726,44,53,69,122
4727,4727,202,40,22,62
4728,4728,87,36,95,131
4729,4729,321,34,30,64
4730,4730,155,14,35,49
4731,4731,285,14,45,59
4732,4732,380,10,84,94
4733,4733,277,34,60,94
4734,4734,83,51,83,134
4735,4735,24,12,115,127
4736,4736,9,45,70,115
4737,4737,447,42,77,119
4738,4738,438,50,67,117
4739,4739,174,54,78,132
4740,4740,414,45,37,82
4741,4741,343,38,106,144
4742,4742,470,39,72,111
4743,4743,73,11,32,43
4744,4744,36,58,16,74
4745,4745,208,39,76,115
4746,4746,54,52,60,112
4747,4747,424,45,36,81
4748,4748,160,46,65,111
4749,4749,147,31,94,125
4750,4750,183,25,46,71
4751,4751,353,44,111,155
4752,4752,6,59,119,178
4753,4753,291,33,82,115
4754,4754,405,21,110,131
4755,4755,216,11,70,81
4756,4756,410,58,19,77
4757,4757,269,51,83,134
4758,4758,201,34,78,112
4759,4759,81,22,110,132
4760,4760,203,59,20,79
4761,4761,440,34,71,105
4762,4762,438,37,42,79
4763,4763,251,50,119,169
4764,4764,311,18,96,114
4765,4765,178,10,51,61
4766,4766,203,22,26,48
4767,4767,176,25,47,72
4768,4768,182,36,120,156
4769,4769,224,57,104,161
4770,4770,453,56,59,115
4771,4771,455,52,87,139
4772,4772,171,27,22,49
4773,4773,229,21,93,114
4774,4774,372,24,115,139
4775,4775,444,21,64,85
4776,4776,411,16,28,44
4777,4777,466,46,22,68
4778,4778,271,54,81,135
4779,4779,354,17,77,94
4780,4780,252,25,112,137
4781,4781,88,21,26,47
4782,4782,212,60,97,157
4783,4783,310,11,53,64
4784,4784,391,11,109,120
4785,4785,424,37,91,128
4786,4786,251,52,101,153
4787,4787,300,22,72,94
4788,4788,208,13,120,133
4789,4789,422,17,100,117
4790,4790,348,14,77,91
4791,4791,53,33,89,122
4792,4792,303,46,25,71
4793,4793,455,34,72,106
4794,4794,184,19,24,43
4795,4795,386,55,103,158
4796,4796,44,50,97,147
4797,4797,35,11,69,80
4798,4798,178,28,113,141
4799,4799,406,44,24,68
4800,4800,91,18,85,103
4801,4801,341,30,31,61
4802,4802,426,16,74,90
4803,4803,169,23,15,38
4804,4804,59,51,114,165
4805,4805,352,15,25,40
4806,4806,429,48,72,120
4807,4807,126,47,104,151
4808,4808,460,40,56,96
4809,4809,442,26,23,49
4810,4810,407,31,66,97
4811,4811,32,36,32,68
4812,4812,421,11,76,87
4813,4813,313,58,15,73
4814,4814,412,34,54,88
4815,4815,463,29,92,121
4816,4816,231,31,57,88
4817,4817,302,20,41,61
4818,4818,330,31,16,47
4819,4819,136,46,114,160
4820,4820,184,34,40,74
4821,4821,231,39,70,109
4822,4822,340,51,93,144
4823,4823,264,60,43,103
4824,4824,63,45,98,143
4825,4825,437,25,27,52
4826,4826,170,48,25,73
4827,4827,425,18,79,97
4828,4828,65,23,84,107
4829,4829,209,31,60,91
4830,4830,393,11,64,75
4831,4831,129,59,105,164
4832,4832,147,54,49,103
4833,4833,364,35,42,77
4834,4834,65,23,68,91
4835,4835,434,25,66,91
4836,4836,454,36,58,94
4837,4837,145,24,89,113
4838,4838,169,12,55,67
4839,4839,138,23,49,72
4840,4840,470,18,119,137
4841,4841,382,50,115,165
4842,4842,335,11,72,83
4843,4843,147,43,23,66
4844,4844,382,29,81,110
4845,4845,370,34,96,130
4846,4846,52,59,67,126
4847,4847,198,33,20,53
4848,4848,458,48,49,97
4849,4849,148,38,64,102
4850,4850,347,11,57,68
4851,4851,142,12,59,71
4852,4852,187,29,74,103
4853,4853,26,54,120,174
4854,4854,288,45,85,130
4855,4855,431,17,51,68
4856,4856,418,51,77,128
4857,4857,23,15,47,62
4858,4858,151,15,35,50
4859,4859,190,42,81,123
4860,4860,51,30,27,57
4861,4861,110,48,70,118
4862,4862,455,56,25,81
4863,4863,175,28,87,115
4864,4864,213,46,18,64
4865,4865,479,49,15,64
4866,4866,255,58,56,114
4867,4867,191,12,83,95
4868,4868,282,21,92,113
4869,4869,315,49,67,116
4870,4870,109,39,74,113
4871,4871,240,55,47,102
4872,4872,259,25,87,112
4873,4873,70,54,93,147
4874,4874,79,10,68,78
4875,4875,65,15,35,50
4876,4876,156,23,38,61
4877,4877,435,14,50,64
4878,4878,129,15,108,123
4879,4879,452,22,110,132
4880,4880,416,42,86,128
4881,4881,52,49,46,95
4882,4882,19,33,45,78
4883,4883,291,21,35,56
4884,4884,423,25,79,104
4885,4885,234,39,29,68
4886,4886,130,27,76,103
4887,4887,328,58,74,132
4888,4888,110,53,44,97
4889,4889,365,49,67,116
4890,4890,434,10,82,92
4891,4891,75,19,63,82
4892,4892,26,14,28,42
4893,4893,479,46,29,75
4894,4894,28,21,21,42
4895,4895,9,52,62,114
4896,4896,301,11,34,45
4897,4897,344,44,32,76
4898,4898,63,20,33,53
4899,4899,448,20,15,35
4900,4900,366,24,34,58
4901,4901,293,13,41,54
4902,4902,296,26,60,86
4903,4903,465,19,60,79
4904,4904,35,37,30,67
4905,4905,404,40,41,81
4906,4906,381,48,34,82
4907,4907,372,42,66,108
4908,4908,455,21,63,84
4909,4909,52,35,22,57
4910,4910,267,13,51,64
4911,4911,118,43,72,115
4912,4912,149,50,97,147
4913,4913,182,27,82,109
4914,4914,200,17,117,134
4915,4915,420,22,85,107
4916,4916,306,35,103,138
4917,4917,154,30,22,52
4918,4918,417,15,91,106
4919,4919,311,35,76,111
4920,4920,280,51,36,87
4921,4921,108,41,84,125
4922,4922,388,27,70,97
4923,4923,320,43,46,89
4924,4924,97,17,36,53
4925,4925,155,15,105,120
4926,4926,19,11,47,58
4927,4927,319,19,48,67
4928,4928,264,35,53,88
4929,4929,374,45,71,116
4930,4930,23,55,92,147
4931,4931,228,44,107,151
4932,4932,328,14,49,63
4933,4933,249,21,36,57
4934,4934,75,15,78,93
4935,4935,157,20,30,50
4936,4936,13,50,115,165
4937,4937,175,33,120,153
4938,4938,231,59,42,101
4939,4939,3,57,49,106
4940,4940,167,24,77,101
4941,4941,438,54,20,74
4942,4942,10,45,76,121
4943,4943,286,29,27,56
4944,4944,411,19,18,37
4945,4945,23,42,53,95
4946,4946,314,50,64,114
4947,4947,422,41,92,133
4948,4948,463,54,28,82
4949,4949,335,50,110,160
4950,4950,92,39,34,73
4951,4951,406,52,103,155
4952,4952,400,27,52,79
4953,4953,375,52,28,80
4954,4954,161,19,98,117
4955,4955,112,39,90,129
4956,4956,445,13,52,65
4957,4957,38,17,44,61
4958,4958,431,45,76,121
4959,4959,248,43,117,160
4960,4960,121,19,64,83
4961,4961,165,21,35,56
4962,4962,83,46,46,92
4963,4963,118,23,17,40
4964,4964,397,39,93,132
4965,4965,189,36,75,111
4966,4966,40,28,111,139
4967,4967,216,21,75,96
4968,4968,177,40,41,81
4969,4969,306,13,28,41
4970,4970,438,29,119,148
4971,4971,401,52,100,152
4972,4972,404,41,23,64
4973,4973,331,22,117,139
4974,4974,315,21,42,63
4975,4975,153,54,49,103
4976,4976,143,50,92,142
4977,4977,88,44,27,71
4978,4978,46,33,60,93
4979,4979,352,20,26,46
4980,4980,456,46,26,72
4981,4981,245,19,114,133
4982,4982,244,46,100,146
4983,4983,159,20,30,50
4984,4984,212,34,65,99
4985,4985,55,22,31,53
4986,4986,222,12,120,132
4987,4987,227,45,63,108
4988,4988,98,48,36,84
4989,4989,435,55,48,103
4990,4990,401,32,80,112
4991,4991,430,27,117,144
4992,4992,1,58,113,171
4993,4993,238,28,48,76
4994,4994,224,48,105,153
4995,4995,149,47,103,150
4996,4996,106,35,26,61
4997,4997,108,52,56,108
4998,4998,180,36,54,90
4999,4999,259,16,58,74
5000,5000,390,19,89,108
5001,5001,458,54,26,80
5002,5002,156,21,80,101
5003,5003,373,34,108,142
5004,5004,472,19,35,54
5005,5005,97,37,30,67
5006,5006,478,12,77,89
5007,5007,177,17,67,84
5008,5008,446,16,47,63
5009,5009,381,34,107,141
5010,5010,364,50,105,155
5011,5011,379,11,62,73
5012,5012,234,15,93,108
5013,5013,249,17,62,79
5014,5014,426,11,72,83
5015,5015,186,24,101,125
5016,5016,50,47,69,116
5017,5017,444,34,80,114
5018,5018,379,32,58,90
5019,5019,238,51,106,157
5020,5020,151,30,112,142
5021,5021,257,42,94,136
5022,5022,96,49,41,90
5023,5023,88,13,77,90
5024,5024,230,10,33,43
5025,5025,73,46,29,75
5026,5026,405,36,16,52
5027,5027,309,35,72,107
5028,5028,103,21,49,70
5029,5029,203,52,65,117
5030,5030,54,34,57,91
5031,5031,277,34,99,133
5032,5032,222,60,19,79
5033,5033,92,28,48,76
5034,5034,193,24,67,91
5035,5035,246,58,65,123
5036,5036,366,32,50,82
5037,5037,221,46,100,146
5038,5038,249,14,73,87
5039,5039,248,29,28,57
5040,5040,474,23,54,77
5041,5041,372,35,50,85
5042,5042,185,16,96,112
5043,5043,163,17,50,67
5044,5044,30,39,49,88
5045,5045,14,24,15,39
5046,5046,336,21,119,140
5047,5047,341,48,36,84
5048,5048,49,60,75,135
5049,5049,233,40,64,104
5050,5050,69,21,85,106
5051,5051,72,45,112,157
5052,5052,224,33,30,63
5053,5053,283,47,91,138
5054,5054,435,45,31,76
5055,5055,180,39,110,149
5056,5056,457,30,22,52
5057,5057,426,28,99,127
5058,5058,201,18,59,77
5059,5059,79,20,51,71
5060,5060,458,47,53,100
5061,5061,198,19,117,136
5062,5062,292,58,101,159
5063,5063,178,40,119,159
5064,5064,388,43,29,72
5065,5065,288,49,20,69
5066,5066,181,21,95,116
5067,5067,103,14,103,117
5068,5068,344,23,92,115
5069,5069,383,53,26,79
5070,5070,265,34,100,134
5071,5071,278,59,105,164
5072,5072,89,26,50,76
5073,5073,382,26,21,47
5074,5074,284,17,44,61
5075,5075,116,46,25,71
5076,5076,352,44,23,67
5077,5077,450,25,50,75
5078,5078,171,58,34,92
5079,5079,255,21,47,68
5080,5080,325,39,53,92
5081,5081,11,34,82,116
5082,5082,418,56,91,147
5083,5083,322,49,115,164
5084,5084,183,56,19,75
5085,5085,72,57,70,127
5086,5086,394,42,66,108
5087,5087,365,19,30,49
5088,5088,230,55,93,148
5089,5089,173,48,50,98
5090,5090,173,18,48,66
5091,5091,89,31,50,81
5092,5092,160,19,80,99
5093,5093,52,13,94,107
5094,5094,185,37,29,66
5095,5095,458,12,111,123
5096,5096,253,23,102,125
5097,5097,344,17,103,120
5098,5098,35,56,51,107
5099,5099,187,49,66,115
5100,5100,336,30,63,93
5101,5101,372,20,93,113
5102,5102,251,35,119,154
5103,5103,233,19,69,88
5104,5104,406,60,40,100
5105,5105,211,12,53,65
5106,5106,34,35,110,145
5107,5107,314,48,71,119
5108,5108,394,50,33,83
5109,5109,160,41,56,97
5110,5110,383,11,78,89
5111,5111,297,17,86,103
5112,5112,473,34,86,120
5113,5113,294,26,42,68
5114,5114,46,41,90,131
5115,5115,120,53,91,144
5116,5116,80,30,31,61
5117,5117,189,52,90,142
5118,5118,360,39,110,149
5119,5119,326,14,43,57
5120,5120,403,54,45,99
5121,5121,280,30,68,98
5122,5122,443,21,17,38
5123,5123,57,44,64,108
5124,5124,127,40,54,94
5125,5125,45,20,58,78
5126,5126,465,51,77,128
5127,5127,148,32,99,131
5128,5128,224,39,117,156
5129,5129,88,49,50,99
5130,5130,77,49,71,120
5131,5131,119,13,107,120
5132,5132,422,41,66,107
5133,5133,425,21,53,74
5134,5134,51,56,117,173
5135,5135,469,60,113,173
5136,5136,258,15,66,81
5137,5137,417,17,48,65
5138,5138,158,15,83,98
5139,5139,340,46,56,102
5140,5140,371,43,66,109
5141,5141,399,49,61,110
5142,5142,347,34,75,109
5143,5143,435,49,50,99
5144,5144,208,44,102,146
5145,5145,396,56,100,156
5146,5146,247,51,78,129
5147,5147,362,50,22,72
5148,5148,177,60,107,167
5149,5149,310,58,120,178
5150,5150,462,15,26,41
5151,5151,374,14,50,64
5152,5152,157,22,70,92
5153,5153,357,42,86,128
5154,5154,202,42,59,101
5155,5155,380,48,79,127
5156,5156,356,41,48,89
5157,5157,114,60,108,168
5158,5158,329,50,104,154
5159,5159,15,40,34,74
5160,5160,411,14,56,70
5161,5161,372,14,113,127
5162,5162,405,19,20,39
5163,5163,62,55,95,150
5164,5164,60,17,16,33
5165,5165,136,30,79,109
5166,5166,187,33,15,48
5167,5167,201,48,93,141
5168,5168,360,20,113,133
5169,5169,111,31,20,51
5170,5170,402,57,52,109
5171,5171,315,56,84,140
5172,5172,375,22,101,123
5173,5173,369,25,77,102
5174,5174,116,55,16,71
5175,5175,411,46,69,115
5176,5176,98,53,21,74
5177,5177,300,33,26,59
5178,5178,14,37,19,56
5179,5179,41,23,94,117
5180,5180,256,27,26,53
5181,5181,47,36,45,81
5182,5182,58,57,69,126
5183,5183,345,21,91,112
5184,5184,170,18,18,36
5185,5185,95,33,85,118
5186,5186,257,28,23,51
5187,5187,326,40,57,97
5188,5188,322,26,48,74
5189,5189,224,12,116,128
5190,5190,114,55,54,109
5191,5191,116,29,68,97
5192,5192,84,18,66,84
5193,5193,118,48,57,105
5194,5194,187,44,105,149
5195,5195,105,37,56,93
5196,5196,183,57,107,164
5197,5197,452,24,69,93
5198,5198,79,59,40,99
5199,5199,481,46,57,103
5200,5200,305,39,26,65
5201,5201,186,12,33,45
5202,5202,293,45,97,142
5203,5203,343,30,61,91
5204,5204,6,21,62,83
5205,5205,135,30,90,120
5206,5206,190,38,71,109
5207,5207,457,16,97,113
5208,5208,252,25,33,58
5209,5209,387,54,19,73
5210,5210,335,15,34,49
5211,5211,325,49,120,169
5212,5212,153,22,73,95
5213,5213,88,30,99,129
5214,5214,60,28,18,46
5215,5215,114,44,93,137
5216,5216,210,22,28,50
5217,5217,192,55,110,165
5218,5218,212,44,89,133
5219,5219,147,58,23,81
5220,5220,201,47,71,118
5221,5221,379,59,16,75
5222,5222,457,18,69,87
5223,5223,175,19,114,133
5224,5224,467,40,66,106
5225,5225,139,16,65,81
5226,5226,379,36,21,57
5227,5227,226,58,99,157
5228,5228,244,11,111,122
5229,5229,478,25,61,86
5230,5230,320,18,16,34
5231,5231,285,39,72,111
5232,5232,253,36,53,89
5233,5233,300,50,27,77
5234,5234,227,47,91,138
5235,5235,459,37,45,82
5236,5236,339,23,53,76
5237,5237,290,31,95,126
5238,5238,142,36,83,119
5239,5239,12,10,97,107
5240,5240,360,57,111,168
5241,5241,440,15,70,85
5242,5242,256,30,33,63
5243,5243,205,17,16,33
5244,5244,448,47,96,143
5245,5245,321,46,50,96
5246,5246,273,40,52,92
5247,5247,318,42,78,120
5248,5248,373,55,99,154
5249,5249,146,54,62,116
5250,5250,318,59,110,169
5251,5251,293,56,95,151
5252,5252,197,46,20,66
5253,5253,26,51,17,68
5254,5254,477,18,95,113
5255,5255,411,53,46,99
5256,5256,326,57,111,168
5257,5257,442,60,79,139
5258,5258,39,27,66,93
5259,5259,301,47,66,113
5260,5260,407,31,36,67
5261,5261,424,16,29,45
5262,5262,266,27,85,112
5263,5263,120,60,85,145
5264,5264,94,23,15,38
5265,5265,369,54,56,110
5266,5266,405,27,87,114
5267,5267,220,49,49,98
5268,5268,466,57,26,83
5269,5269,233,28,60,88
5270,5270,403,20,16,36
5271,5271,409,30,35,65
5272,5272,44,10,27,37
5273,5273,93,30,116,146
5274,5274,217,27,27,54
5275,5275,114,17,97,114
5276,5276,55,52,33,85
5277,5277,341,31,88,119
5278,5278,462,37,39,76
5279,5279,400,31,112,143
5280,5280,465,48,107,155
5281,5281,149,58,53,111
5282,5282,147,32,80,112
5283,5283,35,59,55,114
5284,5284,371,30,57,87
5285,5285,12,45,46,91
5286,5286,376,41,81,122
5287,5287,253,20,70,90
5288,5288,424,57,49,106
5289,5289,42,22,109,131
5290,5290,50,55,54,109
5291,5291,133,55,18,73
5292,5292,288,53,113,166
5293,5293,432,29,53,82
5294,5294,444,35,111,146
5295,5295,147,42,80,122
5296,5296,24,21,78,99
5297,5297,461,24,89,113
5298,5298,248,37,85,122
5299,5299,306,18,41,59
5300,5300,11,14,91,105
5301,5301,269,12,118,130
5302,5302,397,17,81,98
5303,5303,243,12,55,67
5304,5304,52,38,111,149
5305,5305,405,20,113,133
5306,5306,477,57,18,75
5307,5307,236,29,108,137
5308,5308,39,25,42,67
5309,5309,278,46,23,69
5310,5310,118,47,83,130
5311,5311,394,12,73,85
5312,5312,217,29,96,125
5313,5313,407,54,49,103
5314,5314,428,56,86,142
5315,5315,11,30,28,58
5316,5316,188,36,60,96
5317,5317,453,30,80,110
5318,5318,430,46,61,107
5319,5319,476,34,81,115
5320,5320,314,59,44,103
5321,5321,129,16,71,87
5322,5322,173,41,29,70
5323,5323,91,12,115,127
5324,5324,332,24,82,106
5325,5325,70,22,41,63
5326,5326,379,24,91,115
5327,5327,451,27,92,119
5328,5328,357,60,21,81
5329,5329,16,59,40,99
5330,5330,277,57,65,122
5331,5331,449,30,43,73
5332,5332,331,59,99,158
5333,5333,119,30,120,150
5334,5334,219,37,50,87
5335,5335,234,19,97,116
5336,5336,382,25,78,103
5337,5337,7,14,25,39
5338,5338,460,31,106,137
5339,5339,187,42,60,102
5340,5340,284,31,46,77
5341,5341,231,53,116,169
5342,5342,169,18,117,135
5343,5343,324,48,57,105
5344,5344,463,51,112,163
5345,5345,53,60,113,173
5346,5346,416,31,59,90
5347,5347,295,27,16,43
5348,5348,311,23,28,51
5349,5349,337,34,80,114
5350,5350,173,34,96,130
5351,5351,69,57,41,98
5352,5352,478,45,119,164
5353,5353,232,19,114,133
5354,5354,445,56,119,175
5355,5355,147,42,108,150
5356,5356,310,52,69,121
5357,5357,443,51,110,161
5358,5358,289,17,54,71
5359,5359,87,29,39,68
5360,5360,302,41,117,158
5361,5361,11,31,117,148
5362,5362,451,49,114,163
5363,5363,220,39,109,148
5364,5364,238,48,21,69
5365,5365,206,40,20,60
5366,5366,379,46,86,132
5367,5367,459,33,102,135
5368,5368,107,19,32,51
5369,5369,121,10,87,97
5370,5370,146,23,96,119
5371,5371,389,31,43,74
5372,5372,285,18,96,114
5373,5373,344,17,87,104
5374,5374,382,40,46,86
5375,5375,298,58,81,139
5376,5376,440,48,28,76
5377,5377,180,33,67,100
5378,5378,433,31,47,78
5379,5379,305,42,118,160
5380,5380,305,53,55,108
5381,5381,270,41,34,75
5382,5382,300,11,75,86
5383,5383,172,14,46,60
5384,5384,460,58,49,107
5385,5385,110,59,112,171
5386,5386,196,56,18,74
5387,5387,337,21,74,95
5388,5388,327,22,41,63
5389,5389,302,55,102,157
5390,5390,424,33,111,144
5391,5391,256,35,56,91
5392,5392,95,44,114,158
5393,5393,176,40,35,75
5394,5394,34,46,50,96
5395,5395,417,30,39,69
5396,5396,478,15,94,109
5397,5397,406,33,74,107
5398,5398,228,16,85,101
5399,5399,14,47,63,110
5400,5400,323,42,75,117
5401,5401,62,18,38,56
5402,5402,426,40,29,69
5403,5403,264,56,119,175
5404,5404,154,11,44,55
5405,5405,396,43,61,104
5406,5406,77,57,118,175
5407,5407,363,60,28,88
5408,5408,257,16,30,46
5409,5409,19,25,88,113
5410,5410,127,54,17,71
5411,5411,411,26,84,110
5412,5412,192,31,78,109
5413,5413,71,27,63,90
5414,5414,474,37,48,85
5415,5415,247,58,87,145
5416,5416,397,40,66,106
5417,5417,402,31,119,150
5418,5418,212,36,66,102
5419,5419,105,13,23,36
5420,5420,474,31,44,75
5421,5421,249,17,67,84
5422,5422,277,23,111,134
5423,5423,88,55,61,116
5424,5424,86,23,97,120
5425,5425,254,26,62,88
5426,5426,183,26,60,86
5427,5427,243,37,115,152
5428,5428,126,46,60,106
5429,5429,13,15,108,123
5430,5430,49,14,110,124
5431,5431,358,33,22,55
5432,5432,384,51,45,96
5433,5433,196,22,38,60
5434,5434,436,24,108,132
5435,5435,304,11,83,94
5436,5436,414,43,117,160
5437,5437,156,30,93,123
5438,5438,200,60,66,126
5439,5439,237,48,98,146
5440,5440,390,22,37,59
5441,5441,40,36,89,125
5442,5442,236,40,60,100
5443,5443,126,29,40,69
5444,5444,186,47,114,161
5445,5445,345,26,78,104
5446,5446,225,26,105,131
5447,5447,190,12,71,83
5448,5448,335,48,20,68
5449,5449,204,32,116,148
5450,5450,366,13,83,96
5451,5451,362,29,27,56
5452,5452,470,45,114,159
5453,5453,100,18,113,131
5454,5454,384,33,76,109
5455,5455,320,32,70,102
5456,5456,393,12,58,70
5457,5457,40,45,25,70
5458,5458,465,36,30,66
5459,5459,463,45,104,149
5460,5460,248,26,101,127
5461,5461,45,30,101,131
5462,5462,41,54,27,81
5463,5463,233,15,71,86
5464,5464,119,37,103,140
5465,5465,386,59,57,116
5466,5466,294,10,72,82
5467,5467,321,22,65,87
5468,5468,340,37,30,67
5469,5469,309,46,31,77
5470,5470,321,57,97,154
5471,5471,480,29,108,137
5472,5472,135,30,77,107
5473,5473,281,35,100,135
5474,5474,122,28,57,85
5475,5475,80,51,89,140
5476,5476,144,57,100,157
5477,5477,41,27,76,103
5478,5478,269,60,53,113
5479,5479,262,17,53,70
5480,5480,229,10,73,83
5481,5481,26,20,96,116
5482,5482,58,27,103,130
5483,5483,32,41,72,113
5484,5484,252,55,42,97
5485,5485,355,21,50,71
5486,5486,20,18,68,86
5487,5487,413,27,50,77
5488,5488,89,60,20,80
5489,5489,96,45,44,89
5490,5490,28,37,103,140
5491,5491,366,42,53,95
5492,5492,390,43,97,140
5493,5493,80,40,106,146
5494,5494,160,18,92,110
5495,5495,249,41,46,87
5496,5496,478,12,90,102
5497,5497,122,42,15,57
5498,5498,168,26,85,111
5499,5499,413,16,107,123
5500,5500,352,24,15,39
5501,5501,395,19,34,53
5502,5502,220,41,86,127
5503,5503,332,54,26,80
5504,5504,105,46,75,121
5505,5505,54,11,56,67
5506,5506,102,37,112,149
5507,5507,370,40,22,62
5508,5508,194,58,47,105
5509,5509,185,59,27,86
5510,5510,181,57,26,83
5511,5511,4,52,65,117
5512,5512,282,41,29,70
5513,5513,376,48,32,80
5514,5514,277,14,54,68
5515,5515,92,12,88,100
5516,5516,357,17,96,113
5517,5517,238,60,103,163
5518,5518,217,30,39,69
5519,5519,91,23,105,128
5520,5520,233,41,43,84
5521,5521,383,37,86,123
5522,5522,307,31,93,124
5523,5523,153,50,39,89
5524,5524,431,60,93,153
5525,5525,437,18,64,82
5526,5526,29,25,36,61
5527,5527,391,34,28,62
5528,5528,2,18,88,106
5529,5529,416,11,59,70
5530,5530,90,36,74,110
5531,5531,12,15,106,121
5532,5532,122,59,50,109
5533,5533,414,51,27,78
5534,5534,289,25,28,53
5535,5535,222,14,91,105
5536,5536,39,23,50,73
5537,5537,142,24,30,54
5538,5538,72,11,44,55
5539,5539,11,41,90,131
5540,5540,54,30,57,87
5541,5541,334,28,99,127
5542,5542,249,46,61,107
5543,5543,135,36,72,108
5544,5544,35,24,46,70
5545,5545,127,24,23,47
5546,5546,471,15,100,115
5547,5547,420,35,73,108
5548,5548,140,52,97,149
5549,5549,131,51,79,130
5550,5550,476,58,79,137
5551,5551,385,59,59,118
5552,5552,122,10,40,50
5553,5553,73,52,118,170
5554,5554,346,35,117,152
5555,5555,469,49,28,77
5556,5556,21,53,109,162
5557,5557,219,24,76,100
5558,5558,212,38,47,85
5559,5559,336,38,112,150
5560,5560,26,11,101,112
5561,5561,318,20,79,99
5562,5562,186,21,35,56
5563,5563,114,23,81,104
5564,5564,36,34,26,60
5565,5565,43,34,98,132
5566,5566,17,53,40,93
5567,5567,50,50,16,66
5568,5568,196,13,95,108
5569,5569,298,46,29,75
5570,5570,382,19,37,56
5571,5571,431,22,118,140
5572,5572,401,58,15,73
5573,5573,268,30,45,75
5574,5574,217,18,30,48
5575,5575,311,32,44,76
5576,5576,234,28,71,99
5577,5577,444,13,100,113
5578,5578,156,58,61,119
5579,5579,302,30,36,66
5580,5580,340,42,66,108
5581,5581,317,19,41,60
5582,5582,134,48,98,146
5583,5583,109,22,33,55
5584,5584,118,16,38,54
5585,5585,331,60,47,107
5586,5586,359,11,31,42
5587,5587,444,23,119,142
5588,5588,457,60,71,131
5589,5589,433,43,66,109
5590,5590,481,30,27,57
5591,5591,423,54,50,104
5592,5592,418,48,80,128
5593,5593,119,43,91,134
5594,5594,302,44,61,105
5595,5595,315,21,105,126
5596,5596,2,45,26,71
5597,5597,425,42,83,125
5598,5598,360,36,75,111
5599,5599,301,51,114,165
5600,5600,168,23,34,57
5601,5601,333,35,119,154
5602,5602,136,35,100,135
5603,5603,133,29,85,114
5604,5604,10,25,101,126
5605,5605,432,32,75,107
5606,5606,366,28,53,81
5607,5607,93,55,91,146
5608,5608,173,16,37,53
5609,5609,376,47,82,129
5610,5610,25,11,92,103
5611,5611,454,50,93,143
5612,5612,439,48,117,165
5613,5613,174,34,106,140
5614,5614,167,58,63,121
5615,5615,27,60,62,122
5616,5616,247,47,42,89
5617,5617,107,14,36,50
5618,5618,333,23,115,138
5619,5619,242,27,109,136
5620,5620,395,47,112,159
5621,5621,435,11,55,66
5622,5622,386,43,101,144
5623,5623,11,25,22,47
5624,5624,135,41,86,127
5625,5625,204,56,97,153
5626,5626,250,31,44,75
5627,5627,135,46,38,84
5628,5628,279,21,43,64
5629,5629,58,13,59,72
5630,5630,251,23,60,83
5631,5631,61,11,86,97
5632,5632,325,24,96,120
5633,5633,82,29,64,93
5634,5634,103,41,41,82
5635,5635,367,35,75,110
5636,5636,204,51,112,163
5637,5637,142,45,41,86
5638,5638,113,45,120,165
5639,5639,67,21,120,141
5640,5640,167,35,72,107
5641,5641,281,24,108,132
5642,5642,403,11,46,57
5643,5643,292,38,67,105
5644,5644,396,11,74,85
5645,5645,5,38,83,121
5646,5646,429,29,76,105
5647,5647,137,54,104,158
5648,5648,222,36,58,94
5649,5649,481,39,84,123
5650,5650,139,37,110,147
5651,5651,360,10,68,78
5652,5652,388,21,104,125
5653,5653,316,39,57,96
5654,5654,378,24,110,134
5655,5655,135,42,100,142
5656,5656,411,30,75,105
5657,5657,105,38,120,158
5658,5658,85,11,67,78
5659,5659,80,18,34,52
5660,5660,114,59,17,76
5661,5661,416,51,29,80
5662,5662,315,59,49,108
5663,5663,479,53,73,126
5664,5664,429,11,51,62
5665,5665,69,59,39,98
5666,5666,445,38,117,155
5667,5667,183,42,88,130
5668,5668,469,14,52,66
5669,5669,401,14,82,96
5670,5670,65,35,62,97
5671,5671,412,16,67,83
5672,5672,82,50,70,120
5673,5673,451,11,116,127
5674,5674,172,19,87,106
5675,5675,282,16,88,104
5676,5676,61,39,30,69
5677,5677,375,55,35,90
5678,5678,324,35,17,52
5679,5679,63,24,31,55
5680,5680,434,32,32,64
5681,5681,443,58,115,173
5682,5682,93,29,46,75
5683,5683,49,32,105,137
5684,5684,246,40,109,149
5685,5685,429,17,50,67
5686,5686,225,26,46,72
5687,5687,60,42,99,141
5688,5688,446,34,83,117
5689,5689,369,53,39,92
5690,5690,267,47,79,126
5691,5691,356,44,22,66
5692,5692,370,52,49,101
5693,5693,453,58,102,160
5694,5694,418,40,52,92
5695,5695,470,24,52,76
5696,5696,241,12,67,79
5697,5697,464,52,109,161
5698,5698,189,54,44,98
5699,5699,138,59,70,129
5700,5700,348,51,105,156
5701,5701,466,45,50,95
5702,5702,95,32,37,69
5703,5703,346,44,65,109
5704,5704,202,25,95,120
5705,5705,102,28,82,110
5706,5706,164,32,77,109
5707,5707,464,42,47,89
5708,5708,201,32,76,108
5709,5709,84,17,76,93
5710,5710,395,29,69,98
5711,5711,250,46,108,154
5712,5712,449,17,88,105
5713,5713,31,16,70,86
5714,5714,241,21,112,133
5715,5715,428,27,83,110
5716,5716,392,10,40,50
5717,5717,135,51,67,118
5718,5718,367,14,82,96
5719,5719,31,50,84,134
5720,5720,426,11,101,112
5721,5721,233,48,23,71
5722,5722,458,30,34,64
5723,5723,283,10,111,121
5724,5724,56,31,118,149
5725,5725,181,39,21,60
5726,5726,223,15,118,133
5727,5727,268,26,19,45
5728,5728,427,25,98,123
5729,5729,466,25,47,72
5730,5730,469,60,44,104
5731,5731,321,43,73,116
5732,5732,107,25,23,48
5733,5733,5,13,113,126
5734,5734,89,52,20,72
5735,5735,418,17,82,99
5736,5736,468,17,62,79
5737,5737,111,10,95,105
5738,5738,133,31,80,111
5739,5739,382,30,37,67
5740,5740,85,37,77,114
5741,5741,197,16,103,119
5742,5742,170,51,79,130
5743,5743,122,24,46,70
5744,5744,336,55,107,162
5745,5745,391,35,60,95
5746,5746,402,35,71,106
5747,5747,315,46,85,131
5748,5748,327,17,42,59
5749,5749,218,13,73,86
5750,5750,163,12,94,106
5751,5751,405,15,63,78
5752,5752,136,20,44,64
5753,5753,64,40,113,153
5754,5754,396,46,72,118
5755,5755,101,39,119,158
5756,5756,42,45,60,105
5757,5757,337,29,73,102
5758,5758,56,13,76,89
5759,5759,255,41,22,63
5760,5760,235,56,84,140
5761,5761,100,33,96,129
5762,5762,370,37,112,149
5763,5763,82,30,113,143
5764,5764,74,43,34,77
5765,5765,196,25,22,47
5766,5766,42,28,56,84
5767,5767,20,33,81,114
5768,5768,29,17,99,116
5769,5769,115,54,104,158
5770,5770,367,54,56,110
5771,5771,210,45,27,72
5772,5772,158,46,59,105
5773,5773,458,10,47,57
5774,5774,87,47,82,129
5775,5775,370,48,24,72
5776,5776,314,24,36,60
5777,5777,169,42,114,156
5778,5778,278,49,19,68
5779,5779,74,50,112,162
5780,5780,130,33,65,98
5781,5781,293,27,16,43
5782,5782,195,44,36,80
5783,5783,139,21,82,103
5784,5784,111,32,73,105
5785,5785,84,12,111,123
5786,5786,327,40,117,157
5787,5787,231,53,94,147
5788,5788,465,60,25,85
5789,5789,268,22,108,130
5790,5790,444,49,58,107
5791,5791,373,46,63,109
5792,5792,329,22,111,133
5793,5793,442,42,77,119
5794,5794,95,45,101,146
5795,5795,250,18,45,63
5796,5796,179,53,76,129
5797,5797,131,22,57,79
5798,5798,91,53,59,112
5799,5799,249,21,112,133
5800,5800,414,46,56,102
5801,5801,85,55,61,116
5802,5802,301,20,100,120
5803,5803,390,44,17,61
5804,5804,219,41,42,83
5805,5805,16,22,19,41
5806,5806,322,50,107,157
5807,5807,196,14,83,97
5808,5808,316,47,99,146
5809,5809,166,40,83,123
5810,5810,354,41,68,109
5811,5811,375,44,66,110
5812,5812,34,51,81,132
5813,5813,261,58,15,73
5814,5814,83,25,118,143
5815,5815,384,35,49,84
5816,5816,439,40,75,115
5817,5817,273,35,110,145
5818,5818,310,52,17,69
5819,5819,435,14,120,134
5820,5820,290,33,113,146
5821,5821,394,45,35,80
5822,5822,423,31,118,149
5823,5823,447,41,65,106
5824,5824,36,37,85,122
5825,5825,243,44,92,136
5826,5826,292,58,17,75
5827,5827,159,26,54,80
5828,5828,98,38,57,95
5829,5829,111,59,114,173
5830,5830,127,30,51,81
5831,5831,78,15,101,116
5832,5832,402,54,102,156
5833,5833,59,26,103,129
5834,5834,388,32,38,70
5835,5835,126,39,90,129
5836,5836,368,37,31,68
5837,5837,185,39,66,105
5838,5838,2,27,55,82
5839,5839,228,47,39,86
5840,5840,346,54,58,112
5841,5841,396,19,96,115
5842,5842,223,18,56,74
5843,5843,306,35,67,102
5844,5844,46,34,94,128
5845,5845,261,53,103,156
5846,5846,441,14,108,122
5847,5847,172,50,106,156
5848,5848,179,14,77,91
5849,5849,28,21,120,141
5850,5850,437,11,15,26
5851,5851,470,40,78,118
5852,5852,115,26,48,74
5853,5853,314,13,44,57
5854,5854,219,43,41,84
5855,5855,427,38,41,79
5856,5856,334,27,114,141
5857,5857,79,33,103,136
5858,5858,398,40,60,100
5859,5859,133,40,84,124
5860,5860,298,47,75,122
5861,5861,150,54,40,94
5862,5862,382,57,82,139
5863,5863,286,59,60,119
5864,5864,388,46,115,161
5865,5865,339,10,65,75
5866,5866,139,26,32,58
5867,5867,27,44,109,153
5868,5868,201,41,17,58
5869,5869,85,12,86,98
5870,5870,11,56,115,171
5871,5871,29,54,45,99
5872,5872,237,39,58,97
5873,5873,179,32,15,47
5874,5874,430,34,98,132
5875,5875,30,24,42,66
5876,5876,269,10,63,73
5877,5877,451,27,21,48
5878,5878,117,40,62,102
5879,5879,340,22,30,52
5880,5880,160,54,74,128
5881,5881,190,55,17,72
5882,5882,86,30,54,84
5883,5883,357,22,87,109
5884,5884,463,50,64,114
5885,5885,193,14,51,65
5886,5886,457,38,53,91
5887,5887,296,54,97,151
5888,5888,363,36,78,114
5889,5889,399,27,62,89
5890,5890,106,20,68,88
5891,5891,234,37,71,108
5892,5892,213,33,117,150
5893,5893,9,50,17,67
5894,5894,179,55,52,107
5895,5895,385,23,81,104
5896,5896,135,33,81,114
5897,5897,69,25,73,98
5898,5898,13,35,67,102
5899,5899,29,46,79,125
5900,5900,465,14,61,75
5901,5901,15,20,113,133
5902,5902,46,34,66,100
5903,5903,348,21,80,101
5904,5904,306,46,57,103
5905,5905,336,50,60,110
5906,5906,55,17,77,94
5907,5907,309,52,75,127
5908,5908,267,23,93,116
5909,5909,159,24,22,46
5910,5910,465,40,81,121
5911,5911,298,38,44,82
5912,5912,320,23,42,65
5913,5913,57,46,99,145
5914,5914,259,37,42,79
5915,5915,471,27,105,132
5916,5916,326,18,40,58
5917,5917,70,55,25,80
5918,5918,41,60,88,148
5919,5919,171,58,83,141
5920,5920,143,18,71,89
5921,5921,219,21,59,80
5922,5922,300,11,60,71
5923,5923,49,42,58,100
5924,5924,89,54,28,82
5925,5925,475,50,32,82
5926,5926,134,30,62,92
5927,5927,183,24,94,118
5928,5928,57,20,23,43
5929,5929,373,14,88,102
5930,5930,78,24,92,116
5931,5931,369,57,82,139
5932,5932,294,32,76,108
5933,5933,390,56,52,108
5934,5934,379,49,83,132
5935,5935,37,13,77,90
5936,5936,298,10,59,69
5937,5937,443,34,102,136
5938,5938,60,50,111,161
5939,5939,295,51,18,69
5940,5940,232,59,86,145
5941,5941,171,25,31,56
5942,5942,269,11,85,96
5943,5943,434,46,33,79
5944,5944,342,15,17,32
5945,5945,263,35,22,57
5946,5946,94,15,100,115
5947,5947,81,15,63,78
5948,5948,13,19,100,119
5949,5949,206,58,102,160
5950,5950,404,27,91,118
5951,5951,430,38,28,66
5952,5952,304,41,45,86
5953,5953,155,26,74,100
5954,5954,388,43,110,153
5955,5955,102,52,20,72
5956,5956,215,47,116,163
5957,5957,38,12,38,50
5958,5958,215,13,25,38
5959,5959,178,25,49,74
5960,5960,340,19,77,96
5961,5961,156,54,73,127
5962,5962,418,20,19,39
5963,5963,213,54,115,169
5964,5964,424,42,70,112
5965,5965,366,25,68,93
5966,5966,197,30,39,69
5967,5967,136,38,15,53
5968,5968,297,13,115,128
5969,5969,244,53,62,115
5970,5970,290,24,90,114
5971,5971,77,48,48,96
5972,5972,409,50,53,103
5973,5973,103,52,51,103
5974,5974,410,17,102,119
5975,5975,335,38,81,119
5976,5976,423,47,29,76
5977,5977,284,40,62,102
5978,5978,402,23,56,79
5979,5979,458,18,39,57
5980,5980,55,52,91,143
5981,5981,79,48,21,69
5982,5982,318,57,16,73
5983,5983,54,16,42,58
5984,5984,200,32,24,56
5985,5985,44,11,111,122
5986,5986,251,39,83,122
5987,5987,140,25,103,128
5988,5988,257,43,99,142
5989,5989,81,23,79,102
5990,5990,233,26,101,127
5991,5991,351,40,15,55
5992,5992,13,49,84,133
5993,5993,408,59,23,82
5994,5994,143,32,49,81
5995,5995,143,51,25,76
5996,5996,367,12,112,124
5997,5997,203,40,54,94
5998,5998,41,18,104,122
5999,5999,383,44,54,98
6000,6000,288,31,119,150
6001,6001,314,20,114,134
6002,6002,99,28,78,106
6003,6003,311,26,80,106
6004,6004,449,15,46,61
6005,6005,373,33,22,55
6006,6006,3,45,17,62
6007,6007,290,26,80,106
6008,6008,39,59,50,109
6009,6009,381,38,91,129
6010,6010,440,60,54,114
6011,6011,415,10,44,54
6012,6012,157,40,52,92
6013,6013,253,34,108,142
6014,6014,403,12,38,50
6015,6015,19,57,56,113
6016,6016,18,13,23,36
6017,6017,264,55,108,163
6018,6018,391,30,105,135
6019,6019,416,31,34,65
6020,6020,84,10,106,116
6021,6021,288,53,65,118
6022,6022,87,20,78,98
6023,6023,178,39,57,96
6024,6024,100,50,59,109
6025,6025,480,60,66,126
6026,6026,297,33,116,149
6027,6027,417,53,40,93
6028,6028,295,27,39,66
6029,6029,253,24,69,93
6030,6030,321,32,114,146
6031,6031,13,48,33,81
6032,6032,276,31,48,79
6033,6033,32,46,67,113
6034,6034,71,16,65,81
6035,6035,349,14,59,73
6036,6036,274,12,19,31
6037,6037,122,32,100,132
6038,6038,337,43,59,102
6039,6039,55,52,75,127
6040,6040,291,24,89,113
6041,6041,229,49,74,123
6042,6042,171,44,79,123
6043,6043,64,51,111,162
6044,6044,13,58,45,103
6045,6045,367,33,93,126
6046,6046,118,40,39,79
6047,6047,178,25,115,140
6048,6048,176,53,36,89
6049,6049,136,21,84,105
6050,6050,245,53,69,122
6051,6051,134,55,117,172
6052,6052,63,56,50,106
6053,6053,111,54,120,174
6054,6054,232,34,106,140
6055,6055,252,36,41,77
6056,6056,353,27,35,62
6057,6057,262,20,120,140
6058,6058,367,33,71,104
6059,6059,391,30,63,93
6060,6060,185,44,72,116
6061,6061,5,25,85,110
6062,6062,226,14,67,81
6063,6063,20,42,44,86
6064,6064,113,31,37,68
6065,6065,354,10,107,117
6066,6066,440,57,81,138
6067,6067,71,38,15,53
6068,6068,135,23,118,141
6069,6069,33,50,37,87
6070,6070,25,49,113,162
6071,6071,129,58,35,93
6072,6072,481,58,111,169
6073,6073,242,41,70,111
6074,6074,442,43,24,67
6075,6075,432,44,22,66
6076,6076,370,34,114,148
6077,6077,8,37,61,98
6078,6078,367,53,69,122
6079,6079,256,46,45,91
6080,6080,162,16,114,130
6081,6081,187,51,109,160
6082,6082,480,17,49,66
6083,6083,82,47,115,162
6084,6084,101,29,93,122
6085,6085,439,50,50,100
6086,6086,150,54,53,107
6087,6087,251,24,95,119
6088,6088,86,48,92,140
6089,6089,185,14,102,116
6090,6090,279,14,59,73
6091,6091,132,11,100,111
6092,6092,452,26,109,135
6093,6093,176,59,71,130
6094,6094,443,56,31,87
6095,6095,266,15,117,132
6096,6096,434,10,116,126
6097,6097,338,12,58,70
6098,6098,438,47,111,158
6099,6099,177,18,70,88
6100,6100,164,45,29,74
6101,6101,342,52,16,68
6102,6102,13,15,37,52
6103,6103,143,53,36,89
6104,6104,329,50,15,65
6105,6105,122,41,100,141
6106,6106,249,56,20,76
6107,6107,351,21,87,108
6108,6108,126,20,39,59
6109,6109,159,14,71,85
6110,6110,295,45,18,63
6111,6111,383,43,53,96
6112,6112,48,33,49,82
6113,6113,173,37,43,80
6114,6114,135,58,48,106
6115,6115,387,15,80,95
6116,6116,149,26,105,131
6117,6117,334,44,100,144
6118,6118,63,26,81,107
6119,6119,157,42,111,153
6120,6120,393,20,102,122
6121,6121,113,26,77,103
6122,6122,366,15,47,62
6123,6123,381,60,34,94
6124,6124,85,34,18,52
6125,6125,470,41,106,147
6126,6126,393,57,108,165
6127,6127,259,56,53,109
6128,6128,398,57,34,91
6129,6129,143,28,117,145
6130,6130,81,49,44,93
6131,6131,158,55,65,120
6132,6132,451,42,98,140
6133,6133,15,46,49,95
6134,6134,369,44,51,95
6135,6135,467,12,101,113
6136,6136,237,45,71,116
6137,6137,278,55,67,122
6138,6138,216,41,103,144
6139,6139,299,42,45,87
6140,6140,4,51,26,77
6141,6141,373,10,73,83
6142,6142,65,43,116,159
6143,6143,463,56,44,100
6144,6144,387,45,55,100
6145,6145,95,44,15,59
6146,6146,251,11,47,58
6147,6147,235,32,62,94
6148,6148,86,60,75,135
6149,6149,12,33,86,119
6150,6150,107,28,37,65
6151,6151,161,36,15,51
6152,6152,366,31,51,82
6153,6153,450,41,110,151
6154,6154,307,23,16,39
6155,6155,478,37,91,128
6156,6156,249,53,44,97
6157,6157,158,20,57,77
6158,6158,123,51,52,103
6159,6159,366,54,106,160
6160,6160,364,49,19,68
6161,6161,66,26,48,74
6162,6162,20,12,109,121
6163,6163,328,27,44,71
6164,6164,455,21,52,73
6165,6165,154,56,46,102
6166,6166,417,39,119,158
6167,6167,238,51,117,168
6168,6168,213,28,97,125
6169,6169,135,46,108,154
6170,6170,45,35,92,127
6171,6171,332,38,51,89
6172,6172,416,59,107,166
6173,6173,176,14,95,109
6174,6174,301,15,28,43
6175,6175,57,37,115,152
6176,6176,423,38,72,110
6177,6177,196,16,49,65
6178,6178,425,42,80,122
6179,6179,58,29,71,100
6180,6180,397,53,33,86
6181,6181,42,46,102,148
6182,6182,400,37,111,148
6183,6183,401,44,41,85
6184,6184,14,55,93,148
6185,6185,309,24,34,58
6186,6186,282,13,120,133
6187,6187,345,16,46,62
6188,6188,387,29,112,141
6189,6189,357,28,108,136
6190,6190,319,42,108,150
6191,6191,352,49,65,114
6192,6192,299,38,56,94
6193,6193,111,10,23,33
6194,6194,239,24,32,56
6195,6195,196,47,50,97
6196,6196,67,22,97,119
6197,6197,93,38,20,58
6198,6198,280,31,62,93
6199,6199,201,46,105,151
6200,6200,121,32,23,55
6201,6201,281,13,35,48
6202,6202,227,52,86,138
6203,6203,457,49,44,93
6204,6204,271,36,37,73
6205,6205,276,55,67,122
6206,6206,150,17,65,82
6207,6207,170,26,117,143
6208,6208,363,59,58,117
6209,6209,63,55,94,149
6210,6210,113,24,76,100
6211,6211,458,11,55,66
6212,6212,73,29,84,113
6213,6213,139,37,72,109
6214,6214,30,47,63,110
6215,6215,334,17,28,45
6216,6216,194,47,23,70
6217,6217,463,15,85,100
6218,6218,148,22,58,80
6219,6219,400,50,98,148
6220,6220,20,41,77,118
6221,6221,368,43,79,122
6222,6222,199,34,15,49
6223,6223,283,41,102,143
6224,6224,235,45,90,135
6225,6225,416,23,15,38
6226,6226,315,36,89,125
6227,6227,434,31,21,52
6228,6228,42,24,83,107
6229,6229,245,32,118,150
6230,6230,278,60,52,112
6231,6231,264,44,91,135
6232,6232,227,31,20,51
6233,6233,35,42,61,103
6234,6234,441,36,109,145
6235,6235,276,28,81,109
6236,6236,82,28,15,43
6237,6237,181,38,72,110
6238,6238,335,28,42,70
6239,6239,387,21,63,84
6240,6240,209,45,55,100
6241,6241,283,25,77,102
6242,6242,13,52,84,136
6243,6243,203,13,36,49
6244,6244,277,34,62,96
6245,6245,288,50,19,69
6246,6246,250,34,99,133
6247,6247,54,32,79,111
6248,6248,293,57,34,91
6249,6249,229,53,114,167
6250,6250,216,12,114,126
6251,6251,221,35,115,150
6252,6252,339,50,87,137
6253,6253,247,40,119,159
6254,6254,422,44,30,74
6255,6255,49,22,50,72
6256,6256,412,44,89,133
6257,6257,425,35,31,66
6258,6258,117,34,119,153
6259,6259,119,34,50,84
6260,6260,411,57,46,103
6261,6261,105,29,47,76
6262,6262,386,29,26,55
6263,6263,467,57,63,120
6264,6264,168,31,68,99
6265,6265,227,54,82,136
6266,6266,64,43,104,147
6267,6267,64,21,50,71
6268,6268,300,29,101,130
6269,6269,342,19,77,96
6270,6270,144,35,77,112
6271,6271,291,49,48,97
6272,6272,427,49,62,111
6273,6273,104,21,97,118
6274,6274,434,47,106,153
6275,6275,407,21,95,116
6276,6276,423,53,117,170
6277,6277,382,56,55,111
6278,6278,194,49,72,121
6279,6279,54,16,37,53
6280,6280,169,38,48,86
6281,6281,142,53,78,131
6282,6282,277,58,20,78
6283,6283,445,20,56,76
6284,6284,5,43,83,126
6285,6285,465,13,79,92
6286,6286,79,52,62,114
6287,6287,201,39,56,95
6288,6288,416,43,54,97
6289,6289,194,19,18,37
6290,6290,33,47,37,84
6291,6291,475,37,74,111
6292,6292,10,57,106,163
6293,6293,272,45,97,142
6294,6294,467,15,71,86
6295,6295,1,12,29,41
6296,6296,217,60,15,75
6297,6297,90,42,18,60
6298,6298,453,31,35,66
6299,6299,389,51,93,144
6300,6300,393,10,118,128
6301,6301,142,47,43,90
6302,6302,254,45,66,111
6303,6303,3,29,36,65
6304,6304,3,17,65,82
6305,6305,256,41,68,109
6306,6306,442,41,72,113
6307,6307,95,50,60,110
6308,6308,19,14,92,106
6309,6309,387,45,88,133
6310,6310,350,47,49,96
6311,6311,127,49,67,116
6312,6312,170,27,94,121
6313,6313,478,44,29,73
6314,6314,162,21,29,50
6315,6315,39,38,48,86
6316,6316,176,33,116,149
6317,6317,202,53,120,173
6318,6318,163,41,40,81
6319,6319,177,13,30,43
6320,6320,31,48,104,152
6321,6321,285,27,99,126
6322,6322,278,47,91,138
6323,6323,359,49,22,71
6324,6324,48,50,114,164
6325,6325,437,52,68,120
6326,6326,218,18,43,61
6327,6327,189,12,93,105
6328,6328,212,35,112,147
6329,6329,275,20,32,52
6330,6330,158,37,47,84
6331,6331,190,36,37,73
6332,6332,473,52,40,92
6333,6333,419,54,55,109
6334,6334,476,38,28,66
6335,6335,417,51,102,153
6336,6336,72,57,21,78
6337,6337,149,18,32,50
6338,6338,239,46,47,93
6339,6339,150,55,55,110
6340,6340,83,53,112,165
6341,6341,374,33,69,102
6342,6342,69,25,52,77
6343,6343,160,54,99,153
6344,6344,261,38,66,104
6345,6345,359,23,104,127
6346,6346,322,28,48,76
6347,6347,178,10,25,35
6348,6348,212,36,95,131
6349,6349,180,60,100,160
6350,6350,18,56,107,163
6351,6351,176,28,45,73
6352,6352,479,28,53,81
6353,6353,57,55,117,172
6354,6354,96,59,45,104
6355,6355,119,42,50,92
6356,6356,295,34,21,55
6357,6357,351,39,39,78
6358,6358,296,58,70,128
6359,6359,261,32,115,147
6360,6360,422,51,101,152
6361,6361,184,32,46,78
6362,6362,375,32,56,88
6363,6363,238,52,113,165
6364,6364,95,56,114,170
6365,6365,186,38,42,80
6366,6366,381,10,77,87
6367,6367,178,27,108,135
6368,6368,326,21,35,56
6369,6369,142,54,101,155
6370,6370,48,48,28,76
6371,6371,11,10,50,60
6372,6372,79,19,88,107
6373,6373,89,13,73,86
6374,6374,287,31,24,55
6375,6375,214,35,45,80
6376,6376,144,15,109,124
6377,6377,306,33,25,58
6378,6378,361,14,45,59
6379,6379,397,38,53,91
6380,6380,310,40,96,136
6381,6381,249,50,82,132
6382,6382,153,15,73,88
6383,6383,166,60,25,85
6384,6384,213,18,107,125
6385,6385,390,33,58,91
6386,6386,40,17,108,125
6387,6387,63,41,78,119
6388,6388,202,36,20,56
6389,6389,337,35,56,91
6390,6390,304,49,22,71
6391,6391,403,24,119,143
6392,6392,9,23,22,45
6393,6393,279,39,103,142
6394,6394,80,26,72,98
6395,6395,30,18,113,131
6396,6396,271,44,113,157
6397,6397,34,41,39,80
6398,6398,199,59,77,136
6399,6399,70,37,25,62
6400,6400,352,23,25,48
6401,6401,118,20,17,37
6402,6402,456,46,51,97
6403,6403,20,12,74,86
6404,6404,468,27,57,84
6405,6405,80,39,71,110
6406,6406,57,32,63,95
6407,6407,332,19,29,48
6408,6408,217,17,88,105
6409,6409,1,53,26,79
6410,6410,179,28,40,68
6411,6411,149,42,39,81
6412,6412,129,49,23,72
6413,6413,39,59,108,167
6414,6414,317,17,98,115
6415,6415,409,12,98,110
6416,6416,280,10,119,129
6417,6417,359,19,119,138
6418,6418,275,58,28,86
6419,6419,26,14,60,74
6420,6420,307,55,50,105
6421,6421,416,57,21,78
6422,6422,41,48,68,116
6423,6423,85,54,76,130
6424,6424,395,55,113,168
6425,6425,27,36,33,69
6426,6426,36,59,102,161
6427,6427,69,19,118,137
6428,6428,206,43,90,133
6429,6429,84,45,72,117
6430,6430,190,52,31,83
6431,6431,129,38,63,101
6432,6432,268,21,115,136
6433,6433,444,30,87,117
6434,6434,480,28,66,94
6435,6435,181,54,75,129
6436,6436,469,42,38,80
6437,6437,234,15,44,59
6438,6438,89,49,74,123
6439,6439,439,59,35,94
6440,6440,441,14,93,107
6441,6441,47,18,58,76
6442,6442,238,10,103,113
6443,6443,2,40,72,112
6444,6444,422,34,45,79
6445,6445,308,29,101,130
6446,6446,260,16,60,76
6447,6447,86,56,66,122
6448,6448,380,46,55,101
6449,6449,50,25,94,119
6450,6450,79,37,111,148
6451,6451,384,19,61,80
6452,6452,131,45,17,62
6453,6453,167,16,65,81
6454,6454,443,16,66,82
6455,6455,325,24,117,141
6456,6456,467,36,77,113
6457,6457,321,18,109,127
6458,6458,45,52,61,113
6459,6459,67,17,26,43
6460,6460,314,24,60,84
6461,6461,294,23,100,123
6462,6462,270,37,116,153
6463,6463,260,46,105,151
6464,6464,200,54,88,142
6465,6465,77,39,55,94
6466,6466,365,26,67,93
6467,6467,60,41,46,87
6468,6468,423,31,115,146
6469,6469,342,24,19,43
6470,6470,423,23,73,96
6471,6471,354,37,60,97
6472,6472,141,37,65,102
6473,6473,184,14,22,36
6474,6474,336,31,114,145
6475,6475,251,42,19,61
6476,6476,198,42,112,154
6477,6477,260,40,99,139
6478,6478,396,20,25,45
6479,6479,459,36,57,93
6480,6480,353,42,77,119
6481,6481,180,39,53,92
6482,6482,262,47,18,65
6483,6483,229,26,82,108
6484,6484,332,14,20,34
6485,6485,115,18,112,130
6486,6486,109,58,96,154
6487,6487,392,12,79,91
6488,6488,270,18,114,132
6489,6489,387,40,93,133
6490,6490,167,10,30,40
6491,6491,158,13,18,31
6492,6492,442,17,120,137
6493,6493,164,55,95,150
6494,6494,434,44,75,119
6495,6495,426,18,99,117
6496,6496,107,16,20,36
6497,6497,16,36,98,134
6498,6498,207,50,73,123
6499,6499,7,22,54,76
6500,6500,104,24,65,89
6501,6501,246,45,75,120
6502,6502,425,22,27,49
6503,6503,183,57,94,151
6504,6504,369,29,71,100
6505,6505,219,57,105,162
6506,6506,320,20,62,82
6507,6507,269,39,42,81
6508,6508,115,35,83,118
6509,6509,95,37,48,85
6510,6510,79,41,88,129
6511,6511,251,10,92,102
6512,6512,181,19,70,89
6513,6513,365,46,53,99
6514,6514,58,57,20,77
6515,6515,29,13,62,75
6516,6516,396,30,81,111
6517,6517,454,17,72,89
6518,6518,362,15,20,35
6519,6519,480,36,18,54
6520,6520,317,49,102,151
6521,6521,466,16,52,68
6522,6522,16,49,76,125
6523,6523,472,42,95,137
6524,6524,268,19,115,134
6525,6525,353,25,35,60
6526,6526,185,12,81,93
6527,6527,355,44,45,89
6528,6528,442,53,34,87
6529,6529,372,34,105,139
6530,6530,141,49,17,66
6531,6531,476,58,38,96
6532,6532,318,37,34,71
6533,6533,228,48,78,126
6534,6534,258,57,85,142
6535,6535,339,49,103,152
6536,6536,136,34,44,78
6537,6537,309,22,71,93
6538,6538,317,33,87,120
6539,6539,293,19,33,52
6540,6540,180,54,113,167
6541,6541,121,21,31,52
6542,6542,449,29,65,94
6543,6543,466,10,35,45
6544,6544,208,27,108,135
6545,6545,234,46,108,154
6546,6546,99,29,108,137
6547,6547,158,58,118,176
6548,6548,354,39,64,103
6549,6549,254,25,42,67
6550,6550,177,48,57,105
6551,6551,269,55,92,147
6552,6552,163,37,60,97
6553,6553,45,39,50,89
6554,6554,427,47,98,145
6555,6555,293,31,15,46
6556,6556,416,11,56,67
6557,6557,297,32,50,82
6558,6558,15,22,106,128
6559,6559,366,32,32,64
6560,6560,186,34,67,101
6561,6561,114,42,57,99
6562,6562,119,25,36,61
6563,6563,437,14,119,133
6564,6564,213,53,99,152
6565,6565,40,15,68,83
6566,6566,95,41,91,132
6567,6567,477,25,85,110
6568,6568,178,37,37,74
6569,6569,18,32,110,142
6570,6570,378,30,18,48
6571,6571,165,23,46,69
6572,6572,481,42,27,69
6573,6573,216,23,106,129
6574,6574,120,44,70,114
6575,6575,216,13,77,90
6576,6576,432,15,98,113
6577,6577,5,57,71,128
6578,6578,347,50,94,144
6579,6579,286,11,79,90
6580,6580,59,23,30,53
6581,6581,58,29,67,96
6582,6582,409,52,83,135
6583,6583,45,46,40,86
6584,6584,475,56,81,137
6585,6585,64,36,25,61
6586,6586,76,36,103,139
6587,6587,347,16,18,34
6588,6588,23,40,42,82
6589,6589,387,51,69,120
6590,6590,172,18,58,76
6591,6591,304,26,88,114
6592,6592,365,44,20,64
6593,6593,53,33,102,135
6594,6594,147,13,84,97
6595,6595,223,18,86,104
6596,6596,477,10,52,62
6597,6597,14,12,120,132
6598,6598,6,17,68,85
6599,6599,83,19,108,127
6600,6600,142,42,92,134
6601,6601,137,20,115,135
6602,6602,50,20,97,117
6603,6603,234,45,70,115
6604,6604,278,43,43,86
6605,6605,70,37,49,86
6606,6606,155,35,80,115
6607,6607,400,48,119,167
6608,6608,405,36,85,121
6609,6609,58,27,16,43
6610,6610,472,36,28,64
6611,6611,261,14,56,70
6612,6612,398,46,34,80
6613,6613,232,41,37,78
6614,6614,338,54,118,172
6615,6615,117,30,103,133
6616,6616,143,56,64,120
6617,6617,296,57,26,83
6618,6618,441,47,87,134
6619,6619,463,53,77,130
6620,6620,209,58,90,148
6621,6621,355,50,112,162
6622,6622,462,50,100,150
6623,6623,227,60,68,128
6624,6624,108,11,37,48
6625,6625,33,23,21,44
6626,6626,136,16,15,31
6627,6627,86,60,22,82
6628,6628,238,15,115,130
6629,6629,129,43,37,80
6630,6630,22,55,18,73
6631,6631,220,30,106,136
6632,6632,110,41,62,103
6633,6633,176,44,88,132
6634,6634,2,10,107,117
6635,6635,87,33,94,127
6636,6636,198,19,41,60
6637,6637,288,38,113,151
6638,6638,11,44,27,71
6639,6639,304,52,120,172
6640,6640,182,13,72,85
6641,6641,81,41,34,75
6642,6642,406,55,40,95
6643,6643,114,56,84,140
6644,6644,427,45,109,154
6645,6645,221,37,32,69
6646,6646,351,39,107,146
6647,6647,387,46,20,66
6648,6648,468,28,114,142
6649,6649,306,51,49,100
6650,6650,222,13,28,41
6651,6651,45,26,48,74
6652,6652,208,40,52,92
6653,6653,45,39,64,103
6654,6654,399,24,75,99
6655,6655,175,25,48,73
6656,6656,182,49,110,159
6657,6657,219,50,54,104
6658,6658,362,46,40,86
6659,6659,461,29,63,92
6660,6660,284,11,40,51
6661,6661,424,58,51,109
6662,6662,346,26,109,135
6663,6663,147,20,30,50
6664,6664,388,40,81,121
6665,6665,183,50,58,108
6666,6666,413,17,60,77
6667,6667,100,12,37,49
6668,6668,327,57,93,150
6669,6669,361,39,34,73
6670,6670,63,13,19,32
6671,6671,71,31,108,139
6672,6672,81,15,71,86
6673,6673,66,52,51,103
6674,6674,306,50,47,97
6675,6675,321,11,30,41
6676,6676,312,55,105,160
6677,6677,409,47,45,92
6678,6678,55,23,37,60
6679,6679,89,51,110,161
6680,6680,356,12,100,112
6681,6681,82,54,92,146
6682,6682,463,25,39,64
6683,6683,249,29,63,92
6684,6684,37,10,30,40
6685,6685,432,19,28,47
6686,6686,347,60,64,124
6687,6687,171,45,78,123
6688,6688,294,56,56,112
6689,6689,147,60,42,102
6690,6690,442,27,33,60
6691,6691,448,23,33,56
6692,6692,221,11,95,106
6693,6693,61,29,89,118
6694,6694,264,30,38,68
6695,6695,116,60,102,162
6696,6696,437,27,27,54
6697,6697,140,32,118,150
6698,6698,416,60,88,148
6699,6699,453,19,30,49
6700,6700,98,39,84,123
6701,6701,366,26,101,127
6702,6702,227,23,106,129
6703,6703,57,39,67,106
6704,6704,337,51,36,87
6705,6705,276,22,29,51
6706,6706,370,57,20,77
6707,6707,329,45,79,124
6708,6708,68,31,90,121
6709,6709,132,40,67,107
6710,6710,446,15,84,99
6711,6711,93,60,44,104
6712,6712,107,56,80,136
6713,6713,137,47,27,74
6714,6714,28,35,41,76
6715,6715,58,39,57,96
6716,6716,477,38,115,153
6717,6717,229,41,48,89
6718,6718,325,21,47,68
6719,6719,178,54,71,125
6720,6720,206,36,113,149
6721,6721,180,18,96,114
6722,6722,286,13,42,55
6723,6723,281,31,76,107
6724,6724,9,29,100,129
6725,6725,436,59,95,154
6726,6726,149,28,54,82
6727,6727,386,12,81,93
6728,6728,272,33,68,101
6729,6729,271,25,36,61
6730,6730,106,27,64,91
6731,6731,2,59,98,157
6732,6732,426,56,120,176
6733,6733,212,41,88,129
6734,6734,146,41,51,92
6735,6735,12,22,59,81
6736,6736,160,48,80,128
6737,6737,410,51,61,112
6738,6738,323,52,71,123
6739,6739,305,15,35,50
6740,6740,419,33,36,69
6741,6741,126,48,81,129
6742,6742,280,46,105,151
6743,6743,9,23,74,97
6744,6744,374,12,38,50
6745,6745,312,52,110,162
6746,6746,120,31,76,107
6747,6747,284,19,115,134
6748,6748,294,43,41,84
6749,6749,62,45,105,150
6750,6750,233,59,46,105
6751,6751,274,20,56,76
6752,6752,154,17,83,100
6753,6753,2,39,73,112
6754,6754,133,16,83,99
6755,6755,172,41,87,128
6756,6756,407,24,108,132
6757,6757,260,30,87,117
6758,6758,277,55,78,133
6759,6759,57,18,91,109
6760,6760,438,23,67,90
6761,6761,384,40,57,97
6762,6762,427,30,61,91
6763,6763,129,15,76,91
6764,6764,166,38,75,113
6765,6765,455,13,57,70
6766,6766,466,22,56,78
6767,6767,173,24,38,62
6768,6768,131,34,80,114
6769,6769,232,12,111,123
6770,6770,440,25,36,61
6771,6771,153,23,61,84
6772,6772,358,30,34,64
6773,6773,460,44,78,122
6774,6774,22,38,84,122
6775,6775,196,17,50,67
6776,6776,217,37,84,121
6777,6777,378,59,55,114
6778,6778,316,24,102,126
6779,6779,159,56,33,89
6780,6780,384,18,87,105
6781,6781,219,18,87,105
6782,6782,146,35,105,140
6783,6783,354,30,106,136
6784,6784,298,40,94,134
6785,6785,338,45,73,118
6786,6786,206,34,116,150
6787,6787,310,51,53,104
6788,6788,65,43,107,150
6789,6789,289,59,101,160
6790,6790,347,24,20,44
6791,6791,467,24,85,109
6792,6792,112,21,116,137
6793,6793,344,16,32,48
6794,6794,431,17,47,64
6795,6795,82,51,110,161
6796,6796,120,25,25,50
6797,6797,357,23,18,41
6798,6798,290,44,105,149
6799,6799,235,30,54,84
6800,6800,323,13,39,52
6801,6801,208,20,21,41
6802,6802,184,44,32,76
6803,6803,295,29,95,124
6804,6804,408,11,59,70
6805,6805,313,41,60,101
6806,6806,325,42,32,74
6807,6807,244,15,112,127
6808,6808,456,24,61,85
6809,6809,80,48,94,142
6810,6810,261,12,100,112
6811,6811,474,55,18,73
6812,6812,331,19,23,42
6813,6813,421,12,64,76
6814,6814,189,14,62,76
6815,6815,40,35,45,80
6816,6816,195,46,43,89
6817,6817,215,40,72,112
6818,6818,294,50,102,152
6819,6819,479,23,108,131
6820,6820,98,57,25,82
6821,6821,86,36,24,60
6822,6822,60,58,93,151
6823,6823,21,53,28,81
6824,6824,238,30,93,123
6825,6825,204,42,81,123
6826,6826,439,41,89,130
6827,6827,238,53,75,128
6828,6828,255,43,115,158
6829,6829,238,40,76,116
6830,6830,249,11,74,85
6831,6831,353,21,101,122
6832,6832,277,56,77,133
6833,6833,342,28,76,104
6834,6834,235,48,119,167
6835,6835,178,31,29,60
6836,6836,362,58,27,85
6837,6837,257,58,96,154
6838,6838,122,56,38,94
6839,6839,173,55,110,165
6840,6840,423,10,102,112
6841,6841,481,18,29,47
6842,6842,218,53,94,147
6843,6843,252,41,31,72
6844,6844,58,22,115,137
6845,6845,281,18,35,53
6846,6846,229,20,103,123
6847,6847,371,18,66,84
6848,6848,6,47,118,165
6849,6849,93,55,107,162
6850,6850,206,54,37,91
6851,6851,425,15,53,68
6852,6852,59,26,40,66
6853,6853,457,17,97,114
6854,6854,432,48,114,162
6855,6855,421,43,25,68
6856,6856,273,49,117,166
6857,6857,282,17,100,117
6858,6858,436,16,73,89
6859,6859,426,35,91,126
6860,6860,203,13,107,120
6861,6861,139,28,89,117
6862,6862,345,59,54,113
6863,6863,40,60,102,162
6864,6864,140,43,27,70
6865,6865,139,60,109,169
6866,6866,9,20,44,64
6867,6867,2,19,58,77
6868,6868,464,24,110,134
6869,6869,38,30,30,60
6870,6870,132,36,104,140
6871,6871,247,12,110,122
6872,6872,302,55,30,85
6873,6873,316,33,62,95
6874,6874,188,14,116,130
6875,6875,452,59,85,144
6876,6876,406,48,78,126
6877,6877,52,47,27,74
6878,6878,144,34,90,124
6879,6879,161,25,72,97
6880,6880,474,51,57,108
6881,6881,464,25,106,131
6882,6882,284,28,68,96
6883,6883,290,39,66,105
6884,6884,293,27,101,128
6885,6885,352,55,111,166
6886,6886,89,49,27,76
6887,6887,155,23,37,60
6888,6888,406,46,66,112
6889,6889,94,10,95,105
6890,6890,394,36,40,76
6891,6891,222,30,26,56
6892,6892,283,57,62,119
6893,6893,67,15,26,41
6894,6894,243,53,87,140
6895,6895,146,19,83,102
6896,6896,447,54,19,73
6897,6897,26,28,120,148
6898,6898,69,28,81,109
6899,6899,7,30,75,105
6900,6900,204,30,95,125
6901,6901,162,33,114,147
6902,6902,325,14,53,67
6903,6903,112,25,29,54
6904,6904,306,21,39,60
6905,6905,181,43,40,83
6906,6906,59,33,109,142
6907,6907,423,51,78,129
6908,6908,98,36,90,126
6909,6909,10,17,95,112
6910,6910,455,45,41,86
6911,6911,316,20,59,79
6912,6912,355,16,110,126
6913,6913,2,30,43,73
6914,6914,50,47,43,90
6915,6915,125,55,96,151
6916,6916,325,30,68,98
6917,6917,319,11,115,126
6918,6918,287,51,53,104
6919,6919,270,42,78,120
6920,6920,347,14,112,126
6921,6921,106,11,73,84
6922,6922,121,29,67,96
6923,6923,211,58,84,142
6924,6924,286,29,119,148
6925,6925,26,40,74,114
6926,6926,251,23,38,61
6927,6927,16,19,80,99
6928,6928,296,52,86,138
6929,6929,24,45,75,120
6930,6930,10,30,16,46
6931,6931,305,23,103,126
6932,6932,60,43,49,92
6933,6933,297,30,86,116
6934,6934,283,17,44,61
6935,6935,218,44,107,151
6936,6936,18,13,27,40
6937,6937,384,14,116,130
6938,6938,77,42,83,125
6939,6939,353,47,96,143
6940,6940,8,13,92,105
6941,6941,85,36,29,65
6942,6942,184,46,107,153
6943,6943,82,10,112,122
6944,6944,441,45,60,105
6945,6945,19,21,32,53
6946,6946,313,19,89,108
6947,6947,329,16,119,135
6948,6948,133,10,43,53
6949,6949,453,28,49,77
6950,6950,358,19,31,50
6951,6951,451,18,61,79
6952,6952,264,56,54,110
6953,6953,105,57,116,173
6954,6954,257,59,41,100
6955,6955,161,32,88,120
6956,6956,44,54,106,160
6957,6957,364,18,75,93
6958,6958,263,30,43,73
6959,6959,269,43,99,142
6960,6960,177,45,60,105
6961,6961,139,43,58,101
6962,6962,118,11,38,49
6963,6963,104,37,83,120
6964,6964,187,55,73,128
6965,6965,69,22,28,50
6966,6966,257,29,103,132
6967,6967,66,15,80,95
6968,6968,440,40,109,149
6969,6969,446,60,27,87
6970,6970,360,32,38,70
6971,6971,52,49,42,91
6972,6972,318,20,80,100
6973,6973,454,37,70,107
6974,6974,171,43,77,120
6975,6975,409,23,65,88
6976,6976,275,52,66,118
6977,6977,101,11,68,79
6978,6978,42,27,56,83
6979,6979,196,49,77,126
6980,6980,202,41,35,76
6981,6981,422,12,84,96
6982,6982,466,12,33,45
6983,6983,368,29,68,97
6984,6984,251,40,75,115
6985,6985,436,48,72,120
6986,6986,327,21,84,105
6987,6987,393,31,54,85
6988,6988,334,21,30,51
6989,6989,312,45,60,105
6990,6990,419,10,18,28
6991,6991,217,33,78,111
6992,6992,138,58,103,161
6993,6993,24,11,74,85
6994,6994,445,10,94,104
6995,6995,283,14,95,109
6996,6996,319,54,109,163
6997,6997,13,37,89,126
6998,6998,138,30,85,115
6999,6999,163,26,94,120
7000,7000,369,19,42,61
7001,7001,81,52,48,100
7002,7002,92,39,60,99
7003,7003,197,57,98,155
7004,7004,362,15,87,102
7005,7005,282,37,75,112
7006,7006,444,44,45,89
7007,7007,465,14,90,104
7008,7008,110,23,16,39
7009,7009,469,40,47,87
7010,7010,478,48,61,109
7011,7011,217,58,46,104
7012,7012,70,38,65,103
7013,7013,146,59,16,75
7014,7014,26,34,107,141
7015,7015,351,32,120,152
7016,7016,16,12,26,38
7017,7017,386,37,89,126
7018,7018,58,20,78,98
7019,7019,218,21,61,82
7020,7020,204,34,89,123
7021,7021,240,21,111,132
7022,7022,336,26,34,60
7023,7023,248,48,79,127
7024,7024,104,33,32,65
7025,7025,32,59,29,88
7026,7026,422,30,89,119
7027,7027,418,24,119,143
7028,7028,359,25,68,93
7029,7029,216,40,34,74
7030,7030,401,47,94,141
7031,7031,164,34,48,82
7032,7032,209,44,113,157
7033,7033,203,52,87,139
7034,7034,458,42,95,137
7035,7035,189,31,51,82
7036,7036,335,56,52,108
7037,7037,348,29,77,106
7038,7038,19,31,112,143
7039,7039,7,51,54,105
7040,7040,363,38,48,86
7041,7041,294,22,113,135
7042,7042,83,17,33,50
7043,7043,171,31,35,66
7044,7044,151,14,85,99
7045,7045,146,31,21,52
7046,7046,340,30,79,109
7047,7047,143,39,19,58
7048,7048,90,30,27,57
7049,7049,352,25,97,122
7050,7050,255,50,27,77
7051,7051,475,40,48,88
7052,7052,2,41,102,143
7053,7053,248,32,21,53
7054,7054,125,25,63,88
7055,7055,299,46,114,160
7056,7056,459,51,27,78
7057,7057,160,25,109,134
7058,7058,244,20,89,109
7059,7059,167,60,26,86
7060,7060,470,55,75,130
7061,7061,434,39,23,62
7062,7062,344,24,99,123
7063,7063,158,40,96,136
7064,7064,159,49,106,155
7065,7065,379,14,53,67
7066,7066,431,48,102,150
7067,7067,459,43,110,153
7068,7068,220,45,79,124
7069,7069,203,10,70,80
7070,7070,256,25,91,116
7071,7071,453,42,74,116
7072,7072,384,14,18,32
7073,7073,90,12,91,103
7074,7074,428,23,104,127
7075,7075,210,39,16,55
7076,7076,166,42,65,107
7077,7077,223,46,62,108
7078,7078,156,58,30,88
7079,7079,53,11,72,83
7080,7080,265,34,64,98
7081,7081,423,28,40,68
7082,7082,11,32,91,123
7083,7083,230,34,90,124
7084,7084,279,55,26,81
7085,7085,408,56,43,99
7086,7086,229,46,31,77
7087,7087,405,37,46,83
7088,7088,449,43,50,93
7089,7089,235,23,117,140
7090,7090,47,24,118,142
7091,7091,324,15,118,133
7092,7092,62,25,79,104
7093,7093,50,19,69,88
7094,7094,198,48,94,142
7095,7095,325,57,113,170
7096,7096,297,25,41,66
7097,7097,120,46,73,119
7098,7098,295,54,112,166
7099,7099,128,14,82,96
7100,7100,319,26,58,84
7101,7101,97,50,89,139
7102,7102,28,56,83,139
7103,7103,145,27,110,137
7104,7104,49,15,64,79
7105,7105,133,22,81,103
7106,7106,187,19,24,43
7107,7107,115,22,49,71
7108,7108,320,47,105,152
7109,7109,424,14,73,87
7110,7110,430,21,101,122
7111,7111,475,15,109,124
7112,7112,79,48,28,76
7113,7113,371,13,81,94
7114,7114,121,50,59,109
7115,7115,197,35,57,92
7116,7116,309,11,43,54
7117,7117,21,15,104,119
7118,7118,47,14,98,112
7119,7119,164,39,78,117
7120,7120,231,59,60,119
7121,7121,248,29,60,89
7122,7122,255,44,116,160
7123,7123,458,41,94,135
7124,7124,245,55,68,123
7125,7125,37,46,91,137
7126,7126,230,19,78,97
7127,7127,1,60,40,100
7128,7128,5,17,37,54
7129,7129,173,38,94,132
7130,7130,178,59,86,145
7131,7131,257,18,63,81
7132,7132,131,24,41,65
7133,7133,308,25,38,63
7134,7134,276,40,69,109
7135,7135,207,32,69,101
7136,7136,89,25,42,67
7137,7137,332,50,97,147
7138,7138,250,50,32,82
7139,7139,200,38,60,98
7140,7140,385,39,71,110
7141,7141,113,57,83,140
7142,7142,27,56,16,72
7143,7143,16,18,112,130
7144,7144,61,34,111,145
7145,7145,239,25,21,46
7146,7146,152,20,83,103
7147,7147,372,49,36,85
7148,7148,469,29,59,88
7149,7149,480,51,120,171
7150,7150,41,36,24,60
7151,7151,213,13,64,77
7152,7152,133,23,70,93
7153,7153,338,34,17,51
7154,7154,447,54,54,108
7155,7155,226,16,29,45
7156,7156,432,53,95,148
7157,7157,120,45,112,157
7158,7158,18,25,66,91
7159,7159,204,22,49,71
7160,7160,367,29,102,131
7161,7161,465,50,94,144
7162,7162,59,37,102,139
7163,7163,454,37,46,83
7164,7164,431,37,18,55
7165,7165,438,44,28,72
7166,7166,371,26,98,124
7167,7167,112,28,47,75
7168,7168,396,47,44,91
7169,7169,164,21,102,123
7170,7170,108,47,22,69
7171,7171,175,39,101,140
7172,7172,40,24,23,47
7173,7173,271,57,95,152
7174,7174,337,43,23,66
7175,7175,318,13,35,48
7176,7176,264,43,62,105
7177,7177,149,42,39,81
7178,7178,355,13,71,84
7179,7179,201,46,96,142
7180,7180,71,38,90,128
7181,7181,235,46,31,77
7182,7182,120,16,41,57
7183,7183,383,54,46,100
7184,7184,155,41,69,110
7185,7185,471,19,51,70
7186,7186,425,32,82,114
7187,7187,480,31,42,73
7188,7188,261,46,31,77
7189,7189,276,28,91,119
7190,7190,374,39,70,109
7191,7191,414,45,37,82
7192,7192,43,16,110,126
7193,7193,153,25,84,109
7194,7194,43,53,42,95
7195,7195,237,56,64,120
7196,7196,30,16,66,82
7197,7197,59,33,103,136
7198,7198,192,17,73,90
7199,7199,274,17,119,136
7200,7200,433,42,87,129
7201,7201,468,11,35,46
7202,7202,214,18,81,99
7203,7203,438,51,39,90
7204,7204,106,47,22,69
7205,7205,151,23,53,76
7206,7206,202,43,78,121
7207,7207,354,24,31,55
7208,7208,385,46,85,131
7209,7209,95,32,68,100
7210,7210,124,51,119,170
7211,7211,365,12,49,61
7212,7212,204,15,26,41
7213,7213,143,42,66,108
7214,7214,480,37,107,144
7215,7215,136,52,27,79
7216,7216,210,13,21,34
7217,7217,100,57,55,112
7218,7218,93,33,97,130
7219,7219,148,57,72,129
7220,7220,43,59,120,179
7221,7221,117,47,87,134
7222,7222,215,23,45,68
7223,7223,293,41,37,78
7224,7224,179,43,112,155
7225,7225,463,28,18,46
7226,7226,461,23,28,51
7227,7227,18,18,20,38
7228,7228,459,36,90,126
7229,7229,156,33,94,127
7230,7230,293,47,18,65
7231,7231,381,25,101,126
7232,7232,96,19,91,110
7233,7233,121,51,75,126
7234,7234,222,55,24,79
7235,7235,350,11,53,64
7236,7236,201,60,83,143
7237,7237,146,56,46,102
7238,7238,370,15,83,98
7239,7239,22,51,72,123
7240,7240,341,11,24,35
7241,7241,456,28,119,147
7242,7242,272,60,106,166
7243,7243,101,54,78,132
7244,7244,74,22,112,134
7245,7245,145,12,87,99
7246,7246,385,46,85,131
7247,7247,21,33,53,86
7248,7248,479,13,50,63
7249,7249,466,12,27,39
7250,7250,333,53,109,162
7251,7251,449,21,83,104
7252,7252,326,37,41,78
7253,7253,210,56,56,112
7254,7254,27,35,50,85
7255,7255,451,30,74,104
7256,7256,203,52,87,139
7257,7257,370,51,35,86
7258,7258,389,53,35,88
7259,7259,22,56,56,112
7260,7260,218,11,46,57
7261,7261,363,27,62,89
7262,7262,146,31,98,129
7263,7263,165,32,120,152
7264,7264,177,52,47,99
7265,7265,90,20,109,129
7266,7266,275,37,87,124
7267,7267,153,47,75,122
7268,7268,268,32,86,118
7269,7269,407,50,34,84
7270,7270,236,24,89,113
7271,7271,306,44,105,149
7272,7272,312,23,24,47
7273,7273,223,60,77,137
7274,7274,166,37,105,142
7275,7275,210,45,65,110
7276,7276,40,50,118,168
7277,7277,461,53,98,151
7278,7278,347,22,65,87
7279,7279,121,17,16,33
7280,7280,260,58,32,90
7281,7281,63,26,110,136
7282,7282,204,38,98,136
7283,7283,61,50,70,120
7284,7284,395,13,21,34
7285,7285,90,47,29,76
7286,7286,218,42,71,113
7287,7287,466,12,61,73
7288,7288,382,30,100,130
7289,7289,378,32,120,152
7290,7290,454,53,72,125
7291,7291,417,23,89,112
7292,7292,71,17,67,84
7293,7293,74,58,120,178
7294,7294,146,45,35,80
7295,7295,203,43,28,71
7296,7296,184,32,94,126
7297,7297,441,11,56,67
7298,7298,253,14,109,123
7299,7299,311,33,90,123
7300,7300,76,47,81,128
7301,7301,100,36,117,153
7302,7302,49,19,102,121
7303,7303,299,49,55,104
7304,7304,58,54,69,123
7305,7305,242,54,97,151
7306,7306,102,45,51,96
7307,7307,7,44,108,152
7308,7308,73,59,21,80
7309,7309,79,41,85,126
7310,7310,141,13,77,90
7311,7311,31,57,87,144
7312,7312,41,38,95,133
7313,7313,156,24,25,49
7314,7314,153,40,21,61
7315,7315,192,28,31,59
7316,7316,174,48,62,110
7317,7317,258,50,54,104
7318,7318,323,23,74,97
7319,7319,244,42,85,127
7320,7320,249,24,30,54
7321,7321,156,59,36,95
7322,7322,454,14,118,132
7323,7323,242,13,17,30
7324,7324,55,52,21,73
7325,7325,451,36,75,111
7326,7326,333,48,28,76
7327,7327,314,57,102,159
7328,7328,376,22,54,76
7329,7329,362,20,20,40
7330,7330,193,43,78,121
7331,7331,415,52,16,68
7332,7332,365,35,28,63
7333,7333,127,47,20,67
7334,7334,144,32,106,138
7335,7335,258,34,100,134
7336,7336,196,11,51,62
7337,7337,115,37,101,138
7338,7338,268,33,38,71
7339,7339,59,52,76,128
7340,7340,334,26,72,98
7341,7341,335,60,42,102
7342,7342,228,36,78,114
7343,7343,451,14,61,75
7344,7344,206,28,108,136
7345,7345,247,39,81,120
7346,7346,299,21,112,133
7347,7347,159,37,74,111
7348,7348,56,43,48,91
7349,7349,441,57,44,101
7350,7350,245,50,16,66
7351,7351,412,19,45,64
7352,7352,406,26,68,94
7353,7353,287,46,15,61
7354,7354,422,44,100,144
7355,7355,87,48,42,90
7356,7356,266,35,53,88
7357,7357,471,60,57,117
7358,7358,141,57,46,103
7359,7359,468,45,72,117
7360,7360,163,14,94,108
7361,7361,1,36,94,130
7362,7362,34,56,66,122
7363,7363,395,40,32,72
7364,7364,90,13,106,119
7365,7365,295,36,94,130
7366,7366,311,55,105,160
7367,7367,476,13,85,98
7368,7368,448,51,94,145
7369,7369,203,15,113,128
7370,7370,274,57,108,165
7371,7371,61,15,59,74
7372,7372,220,25,43,68
7373,7373,247,19,71,90
7374,7374,83,60,44,104
7375,7375,384,38,40,78
7376,7376,106,32,35,67
7377,7377,69,33,55,88
7378,7378,394,26,95,121
7379,7379,69,53,19,72
7380,7380,46,33,23,56
7381,7381,311,55,19,74
7382,7382,292,20,20,40
7383,7383,324,14,108,122
7384,7384,421,17,23,40
7385,7385,155,57,56,113
7386,7386,214,54,89,143
7387,7387,174,15,100,115
7388,7388,264,36,37,73
7389,7389,119,18,24,42
7390,7390,14,13,87,100
7391,7391,454,25,117,142
7392,7392,121,32,42,74
7393,7393,451,56,57,113
7394,7394,69,56,72,128
7395,7395,8,36,27,63
7396,7396,329,52,111,163
7397,7397,259,60,114,174
7398,7398,193,10,58,68
7399,7399,148,17,101,118
7400,7400,247,47,64,111
7401,7401,162,14,112,126
7402,7402,443,46,97,143
7403,7403,469,35,25,60
7404,7404,267,33,95,128
7405,7405,195,29,38,67
7406,7406,376,47,29,76
7407,7407,75,10,73,83
7408,7408,34,22,94,116
7409,7409,92,40,59,99
7410,7410,198,46,22,68
7411,7411,211,54,26,80
7412,7412,467,55,17,72
7413,7413,238,34,57,91
7414,7414,133,40,119,159
7415,7415,294,36,108,144
7416,7416,481,38,39,77
7417,7417,347,26,21,47
7418,7418,472,60,99,159
7419,7419,98,58,76,134
7420,7420,113,24,69,93
7421,7421,407,37,105,142
7422,7422,453,20,51,71
7423,7423,229,35,36,71
7424,7424,430,40,34,74
7425,7425,139,36,35,71
7426,7426,357,36,29,65
7427,7427,29,46,50,96
7428,7428,383,30,67,97
7429,7429,346,38,116,154
7430,7430,371,23,61,84
7431,7431,354,17,17,34
7432,7432,438,35,120,155
7433,7433,279,17,30,47
7434,7434,379,60,111,171
7435,7435,236,49,76,125
7436,7436,169,54,69,123
7437,7437,127,10,60,70
7438,7438,349,27,100,127
7439,7439,94,21,115,136
7440,7440,24,26,62,88
7441,7441,349,15,56,71
7442,7442,34,22,120,142
7443,7443,242,25,57,82
7444,7444,19,52,45,97
7445,7445,180,23,80,103
7446,7446,135,49,102,151
7447,7447,343,40,55,95
7448,7448,377,28,20,48
7449,7449,288,10,67,77
7450,7450,313,50,82,132
7451,7451,157,19,67,86
7452,7452,232,11,44,55
7453,7453,336,10,90,100
7454,7454,274,36,116,152
7455,7455,10,29,110,139
7456,7456,80,31,93,124
7457,7457,461,30,52,82
7458,7458,237,18,19,37
7459,7459,198,60,113,173
7460,7460,220,25,85,110
7461,7461,195,35,23,58
7462,7462,394,52,28,80
7463,7463,87,18,86,104
7464,7464,339,51,76,127
7465,7465,199,19,108,127
7466,7466,212,15,101,116
7467,7467,350,45,88,133
7468,7468,263,55,116,171
7469,7469,251,55,46,101
7470,7470,228,20,62,82
7471,7471,194,40,27,67
7472,7472,54,54,54,108
7473,7473,329,50,60,110
7474,7474,480,29,101,130
7475,7475,425,18,58,76
7476,7476,286,13,101,114
7477,7477,401,25,16,41
7478,7478,441,13,87,100
7479,7479,135,55,73,128
7480,7480,1,55,81,136
7481,7481,309,13,27,40
7482,7482,161,10,98,108
7483,7483,112,44,44,88
7484,7484,12,50,44,94
7485,7485,371,60,103,163
7486,7486,253,13,51,64
7487,7487,301,53,95,148
7488,7488,250,27,113,140
7489,7489,113,36,29,65
7490,7490,273,44,67,111
7491,7491,320,11,75,86
7492,7492,203,60,62,122
7493,7493,280,20,119,139
7494,7494,347,37,40,77
7495,7495,410,39,58,97
7496,7496,310,21,15,36
7497,7497,290,53,68,121
7498,7498,319,10,82,92
7499,7499,454,57,120,177
7500,7500,333,19,81,100
7501,7501,7,26,47,73
7502,7502,12,14,100,114
7503,7503,259,31,102,133
7504,7504,181,40,81,121
7505,7505,449,19,81,100
7506,7506,6,29,107,136
7507,7507,311,55,56,111
7508,7508,12,23,100,123
7509,7509,216,18,85,103
7510,7510,278,24,37,61
7511,7511,44,13,67,80
7512,7512,27,18,26,44
7513,7513,470,24,106,130
7514,7514,250,49,35,84
7515,7515,106,43,112,155
7516,7516,320,35,36,71
7517,7517,110,12,100,112
7518,7518,144,33,95,128
7519,7519,104,53,69,122
7520,7520,251,32,15,47
7521,7521,217,21,93,114
7522,7522,377,11,96,107
7523,7523,412,23,112,135
7524,7524,181,25,49,74
7525,7525,210,47,44,91
7526,7526,279,25,99,124
7527,7527,193,51,49,100
7528,7528,192,59,73,132
7529,7529,304,53,58,111
7530,7530,476,23,79,102
7531,7531,477,19,70,89
7532,7532,329,48,39,87
7533,7533,177,36,26,62
7534,7534,350,48,105,153
7535,7535,471,29,61,90
7536,7536,413,41,17,58
7537,7537,56,34,70,104
7538,7538,25,60,93,153
7539,7539,409,18,35,53
7540,7540,317,42,48,90
7541,7541,35,50,115,165
7542,7542,439,11,118,129
7543,7543,479,40,39,79
7544,7544,228,47,33,80
7545,7545,222,60,99,159
7546,7546,111,37,35,72
7547,7547,408,54,53,107
7548,7548,343,46,28,74
7549,7549,65,59,61,120
7550,7550,323,52,49,101
7551,7551,277,20,118,138
7552,7552,322,24,23,47
7553,7553,251,50,38,88
7554,7554,80,22,117,139
7555,7555,135,46,104,150
7556,7556,252,50,110,160
7557,7557,130,18,47,65
7558,7558,267,20,114,134
7559,7559,365,44,113,157
7560,7560,181,60,90,150
7561,7561,378,50,45,95
7562,7562,222,19,44,63
7563,7563,222,47,105,152
7564,7564,392,51,37,88
7565,7565,404,34,82,116
7566,7566,281,23,97,120
7567,7567,156,15,81,96
7568,7568,456,11,70,81
7569,7569,386,30,81,111
7570,7570,235,59,69,128
7571,7571,218,45,32,77
7572,7572,52,35,103,138
7573,7573,235,57,23,80
7574,7574,102,18,119,137
7575,7575,257,46,23,69
7576,7576,255,57,19,76
7577,7577,283,60,84,144
7578,7578,328,31,72,103
7579,7579,216,18,111,129
7580,7580,150,59,28,87
7581,7581,195,28,21,49
7582,7582,460,52,114,166
7583,7583,70,35,46,81
7584,7584,215,26,87,113
7585,7585,402,53,83,136
7586,7586,418,40,56,96
7587,7587,131,14,117,131
7588,7588,270,31,96,127
7589,7589,317,42,80,122
7590,7590,319,30,55,85
7591,7591,471,31,59,90
7592,7592,129,32,69,101
7593,7593,438,42,35,77
7594,7594,6,43,92,135
7595,7595,406,23,30,53
7596,7596,48,59,114,173
7597,7597,10,37,78,115
7598,7598,342,52,40,92
7599,7599,149,41,49,90
7600,7600,16,12,116,128
7601,7601,335,58,86,144
7602,7602,19,46,18,64
7603,7603,410,56,48,104
7604,7604,5,16,67,83
7605,7605,50,10,120,130
7606,7606,358,31,116,147
7607,7607,299,19,90,109
7608,7608,310,17,38,55
7609,7609,408,48,88,136
7610,7610,424,56,76,132
7611,7611,122,29,111,140
7612,7612,356,25,54,79
7613,7613,346,42,71,113
7614,7614,193,23,35,58
7615,7615,351,60,77,137
7616,7616,441,46,59,105
7617,7617,184,12,93,105
7618,7618,381,20,119,139
7619,7619,442,45,50,95
7620,7620,175,11,78,89
7621,7621,83,29,70,99
7622,7622,153,10,50,60
7623,7623,375,56,97,153
7624,7624,15,28,61,89
7625,7625,23,15,82,97
7626,7626,234,33,84,117
7627,7627,108,40,64,104
7628,7628,159,38,115,153
7629,7629,305,37,74,111
7630,7630,398,43,78,121
7631,7631,171,34,77,111
7632,7632,176,54,95,149
7633,7633,145,23,27,50
7634,7634,231,44,22,66
7635,7635,378,49,101,150
7636,7636,272,22,105,127
7637,7637,436,44,31,75
7638,7638,151,38,83,121
7639,7639,357,28,72,100
7640,7640,408,25,100,125
7641,7641,342,30,107,137
7642,7642,85,12,62,74
7643,7643,147,55,100,155
7644,7644,113,28,20,48
7645,7645,284,36,87,123
7646,7646,133,58,106,164
7647,7647,388,42,89,131
7648,7648,447,20,111,131
7649,7649,109,36,61,97
7650,7650,423,16,18,34
7651,7651,126,38,63,101
7652,7652,96,21,117,138
7653,7653,438,27,110,137
7654,7654,393,38,81,119
7655,7655,372,53,83,136
7656,7656,93,41,104,145
7657,7657,323,57,71,128
7658,7658,257,47,93,140
7659,7659,116,28,51,79
7660,7660,253,18,24,42
7661,7661,461,15,27,42
7662,7662,103,52,62,114
7663,7663,42,15,89,104
7664,7664,460,48,119,167
7665,7665,214,13,99,112
7666,7666,230,40,27,67
7667,7667,449,26,98,124
7668,7668,405,42,52,94
7669,7669,36,24,85,109
7670,7670,309,38,33,71
7671,7671,159,33,67,100
7672,7672,132,15,50,65
7673,7673,8,35,82,117
7674,7674,218,32,57,89
7675,7675,196,41,79,120
7676,7676,39,41,20,61
7677,7677,381,29,69,98
7678,7678,11,23,99,122
7679,7679,30,44,68,112
7680,7680,207,15,77,92
7681,7681,228,37,67,104
7682,7682,363,47,67,114
7683,7683,251,33,108,141
7684,7684,115,42,87,129
7685,7685,444,10,63,73
7686,7686,409,33,92,125
7687,7687,426,18,27,45
7688,7688,372,32,21,53
7689,7689,108,26,91,117
7690,7690,356,52,59,111
7691,7691,195,55,83,138
7692,7692,312,32,98,130
7693,7693,186,32,58,90
7694,7694,96,18,63,81
7695,7695,451,55,50,105
7696,7696,180,26,98,124
7697,7697,462,59,85,144
7698,7698,259,51,81,132
7699,7699,15,27,61,88
7700,7700,272,50,82,132
7701,7701,274,13,41,54
7702,7702,136,18,106,124
7703,7703,274,43,24,67
7704,7704,75,40,76,116
7705,7705,111,60,98,158
7706,7706,278,15,107,122
7707,7707,419,43,43,86
7708,7708,151,29,42,71
7709,7709,164,52,73,125
7710,7710,338,17,108,125
7711,7711,445,53,35,88
7712,7712,141,10,46,56
7713,7713,196,44,89,133
7714,7714,290,35,94,129
7715,7715,49,11,88,99
7716,7716,160,19,49,68
7717,7717,390,52,20,72
7718,7718,295,30,68,98
7719,7719,440,37,116,153
7720,7720,217,25,39,64
7721,7721,443,35,19,54
7722,7722,76,53,65,118
7723,7723,102,35,57,92
7724,7724,225,31,20,51
7725,7725,228,33,98,131
7726,7726,157,16,60,76
7727,7727,412,26,27,53
7728,7728,18,57,96,153
7729,7729,267,38,60,98
7730,7730,102,11,57,68
7731,7731,22,37,91,128
7732,7732,95,10,17,27
7733,7733,28,48,110,158
7734,7734,135,36,119,155
7735,7735,365,42,105,147
7736,7736,299,32,64,96
7737,7737,331,46,58,104
7738,7738,6,24,105,129
7739,7739,369,38,74,112
7740,7740,404,20,25,45
7741,7741,428,16,101,117
7742,7742,283,31,79,110
7743,7743,316,45,76,121
7744,7744,425,51,102,153
7745,7745,431,17,35,52
7746,7746,183,52,15,67
7747,7747,31,20,120,140
7748,7748,233,32,85,117
7749,7749,474,26,23,49
7750,7750,274,11,30,41
7751,7751,84,41,105,146
7752,7752,130,51,64,115
7753,7753,304,35,91,126
7754,7754,136,20,94,114
7755,7755,172,25,115,140
7756,7756,244,26,83,109
7757,7757,50,43,113,156
7758,7758,43,31,66,97
7759,7759,118,60,37,97
7760,7760,345,31,85,116
7761,7761,25,41,26,67
7762,7762,128,52,113,165
7763,7763,106,53,69,122
7764,7764,7,38,76,114
7765,7765,302,35,82,117
7766,7766,88,25,17,42
7767,7767,14,57,105,162
7768,7768,18,47,103,150
7769,7769,2,51,115,166
7770,7770,429,34,50,84
7771,7771,52,39,26,65
7772,7772,64,53,49,102
7773,7773,51,13,110,123
7774,7774,229,56,36,92
7775,7775,144,51,23,74
7776,7776,70,24,90,114
7777,7777,272,50,120,170
7778,7778,113,43,21,64
7779,7779,472,49,89,138
7780,7780,122,47,111,158
7781,7781,108,30,55,85
7782,7782,180,12,95,107
7783,7783,91,24,104,128
7784,7784,282,39,23,62
7785,7785,145,43,48,91
7786,7786,415,53,44,97
7787,7787,191,60,67,127
7788,7788,409,10,97,107
7789,7789,129,50,66,116
7790,7790,241,27,64,91
7791,7791,481,28,27,55
7792,7792,414,13,107,120
7793,7793,255,35,108,143
7794,7794,130,17,63,80
7795,7795,450,21,36,57
7796,7796,291,56,62,118
7797,7797,406,24,95,119
7798,7798,357,57,101,158
7799,7799,219,59,61,120
7800,7800,14,36,45,81
7801,7801,419,22,23,45
7802,7802,282,19,92,111
7803,7803,389,46,90,136
7804,7804,265,13,108,121
7805,7805,137,57,36,93
7806,7806,349,40,42,82
7807,7807,124,31,55,86
7808,7808,98,50,118,168
7809,7809,304,35,98,133
7810,7810,279,18,34,52
7811,7811,176,40,120,160
7812,7812,479,32,24,56
7813,7813,393,10,70,80
7814,7814,452,34,74,108
7815,7815,258,43,110,153
7816,7816,441,21,63,84
7817,7817,60,43,25,68
7818,7818,383,23,115,138
7819,7819,168,59,38,97
7820,7820,5,58,90,148
7821,7821,287,10,40,50
7822,7822,206,31,39,70
7823,7823,406,14,81,95
7824,7824,87,12,96,108
7825,7825,249,50,46,96
7826,7826,141,36,62,98
7827,7827,161,22,49,71
7828,7828,267,30,105,135
7829,7829,355,37,86,123
7830,7830,329,18,44,62
7831,7831,27,43,44,87
7832,7832,228,52,74,126
7833,7833,359,54,37,91
7834,7834,279,21,40,61
7835,7835,114,50,36,86
7836,7836,442,44,23,67
7837,7837,284,34,32,66
7838,7838,215,17,48,65
7839,7839,309,26,90,116
7840,7840,373,45,60,105
7841,7841,300,49,59,108
7842,7842,32,16,82,98
7843,7843,37,46,118,164
7844,7844,239,39,111,150
7845,7845,117,21,24,45
7846,7846,123,17,54,71
7847,7847,371,48,74,122
7848,7848,266,15,104,119
7849,7849,284,21,107,128
7850,7850,318,33,21,54
7851,7851,22,41,17,58
7852,7852,170,55,116,171
7853,7853,267,46,101,147
7854,7854,237,55,20,75
7855,7855,11,15,107,122
7856,7856,152,32,63,95
7857,7857,244,58,27,85
7858,7858,72,42,24,66
7859,7859,199,25,101,126
7860,7860,213,19,110,129
7861,7861,39,11,120,131
7862,7862,139,37,84,121
7863,7863,474,17,106,123
7864,7864,49,32,105,137
7865,7865,311,31,76,107
7866,7866,106,19,59,78
7867,7867,134,36,68,104
7868,7868,164,36,48,84
7869,7869,399,25,114,139
7870,7870,19,55,74,129
7871,7871,209,25,93,118
7872,7872,371,41,51,92
7873,7873,301,31,26,57
7874,7874,278,51,106,157
7875,7875,424,45,50,95
7876,7876,78,12,117,129
7877,7877,266,17,64,81
7878,7878,95,59,66,125
7879,7879,292,30,111,141
7880,7880,386,53,109,162
7881,7881,170,28,92,120
7882,7882,76,44,44,88
7883,7883,358,48,93,141
7884,7884,212,10,103,113
7885,7885,118,60,107,167
7886,7886,237,56,111,167
7887,7887,60,11,34,45
7888,7888,64,51,101,152
7889,7889,220,11,82,93
7890,7890,330,10,120,130
7891,7891,287,60,83,143
7892,7892,177,56,77,133
7893,7893,141,43,19,62
7894,7894,86,39,82,121
7895,7895,8,48,34,82
7896,7896,347,48,20,68
7897,7897,455,35,38,73
7898,7898,478,37,59,96
7899,7899,296,25,38,63
7900,7900,308,55,30,85
7901,7901,339,51,55,106
7902,7902,294,45,113,158
7903,7903,306,43,92,135
7904,7904,377,40,111,151
7905,7905,469,24,105,129
7906,7906,65,59,110,169
7907,7907,301,13,61,74
7908,7908,426,55,57,112
7909,7909,441,22,57,79
7910,7910,332,36,20,56
7911,7911,338,60,116,176
7912,7912,278,43,35,78
7913,7913,463,19,70,89
7914,7914,208,23,55,78
7915,7915,313,55,105,160
7916,7916,159,12,109,121
7917,7917,36,34,58,92
7918,7918,390,52,86,138
7919,7919,197,12,45,57
7920,7920,24,48,42,90
7921,7921,119,41,20,61
7922,7922,25,58,58,116
7923,7923,75,12,113,125
7924,7924,118,16,73,89
7925,7925,267,23,18,41
7926,7926,118,43,27,70
7927,7927,146,10,105,115
7928,7928,317,42,49,91
7929,7929,379,36,15,51
7930,7930,174,54,83,137
7931,7931,420,46,108,154
7932,7932,232,60,20,80
7933,7933,394,56,61,117
7934,7934,383,53,33,86
7935,7935,441,15,64,79
7936,7936,47,34,33,67
7937,7937,92,50,108,158
7938,7938,283,36,22,58
7939,7939,206,46,116,162
7940,7940,54,35,41,76
7941,7941,421,32,59,91
7942,7942,409,24,15,39
7943,7943,202,37,83,120
7944,7944,227,53,70,123
7945,7945,462,34,86,120
7946,7946,390,29,51,80
7947,7947,159,23,31,54
7948,7948,88,22,55,77
7949,7949,66,32,65,97
7950,7950,350,23,100,123
7951,7951,449,58,75,133
7952,7952,51,14,118,132
7953,7953,46,53,93,146
7954,7954,415,26,91,117
7955,7955,397,10,28,38
7956,7956,306,24,60,84
7957,7957,137,55,53,108
7958,7958,252,37,72,109
7959,7959,352,11,63,74
7960,7960,345,52,44,96
7961,7961,16,52,106,158
7962,7962,364,39,15,54
7963,7963,195,45,55,100
7964,7964,466,46,22,68
7965,7965,306,36,89,125
7966,7966,19,13,22,35
7967,7967,392,25,103,128
7968,7968,144,44,22,66
7969,7969,412,34,45,79
7970,7970,132,58,48,106
7971,7971,148,22,108,130
7972,7972,396,42,23,65
7973,7973,218,31,46,77
7974,7974,54,58,83,141
7975,7975,476,39,72,111
7976,7976,378,29,78,107
7977,7977,318,38,24,62
7978,7978,292,60,39,99
7979,7979,39,17,49,66
7980,7980,33,23,119,142
7981,7981,233,52,31,83
7982,7982,343,35,71,106
7983,7983,295,20,106,126
7984,7984,396,24,33,57
7985,7985,396,57,17,74
7986,7986,336,34,90,124
7987,7987,312,55,54,109
7988,7988,48,35,85,120
7989,7989,149,44,31,75
7990,7990,150,58,83,141
7991,7991,384,21,83,104
7992,7992,128,56,32,88
7993,7993,51,19,48,67
7994,7994,198,38,105,143
7995,7995,40,49,49,98
7996,7996,200,53,67,120
7997,7997,210,14,85,99
7998,7998,403,49,20,69
7999,7999,251,58,97,155
8000,8000,119,39,72,111
8001,8001,229,43,98,141
8002,8002,431,17,97,114
8003,8003,17,39,19,58
8004,8004,276,20,32,52
8005,8005,408,22,40,62
8006,8006,73,33,33,66
8007,8007,425,50,106,156
8008,8008,215,25,96,121
8009,8009,231,39,46,85
8010,8010,72,58,15,73
8011,8011,22,57,21,78
8012,8012,257,37,39,76
8013,8013,15,48,26,74
8014,8014,373,48,60,108
8015,8015,84,17,42,59
8016,8016,88,16,97,113
8017,8017,15,33,74,107
8018,8018,132,26,68,94
8019,8019,448,42,28,70
8020,8020,92,30,110,140
8021,8021,423,27,52,79
8022,8022,346,33,36,69
8023,8023,355,49,102,151
8024,8024,107,38,87,125
8025,8025,55,15,66,81
8026,8026,1,16,28,44
8027,8027,473,44,105,149
8028,8028,249,33,104,137
8029,8029,236,12,34,46
8030,8030,250,11,17,28
8031,8031,23,48,71,119
8032,8032,258,13,39,52
8033,8033,399,40,59,99
8034,8034,185,11,31,42
8035,8035,146,34,92,126
8036,8036,129,39,120,159
8037,8037,261,18,88,106
8038,8038,365,37,113,150
8039,8039,209,53,68,121
8040,8040,259,30,43,73
8041,8041,250,12,63,75
8042,8042,112,18,94,112
8043,8043,292,36,87,123
8044,8044,353,11,30,41
8045,8045,296,33,76,109
8046,8046,378,52,103,155
8047,8047,298,59,20,79
8048,8048,307,48,89,137
8049,8049,18,57,102,159
8050,8050,297,54,100,154
8051,8051,117,14,84,98
8052,8052,461,11,33,44
8053,8053,418,41,58,99
8054,8054,337,24,59,83
8055,8055,218,34,62,96
8056,8056,350,49,39,88
8057,8057,52,21,25,46
8058,8058,163,28,53,81
8059,8059,84,55,75,130
8060,8060,33,37,95,132
8061,8061,453,57,24,81
8062,8062,5,33,116,149
8063,8063,120,12,25,37
8064,8064,216,60,76,136
8065,8065,402,41,62,103
8066,8066,431,46,57,103
8067,8067,187,58,39,97
8068,8068,293,15,93,108
8069,8069,394,56,19,75
8070,8070,8,21,67,88
8071,8071,363,31,100,131
8072,8072,128,34,41,75
8073,8073,73,13,68,81
8074,8074,392,56,86,142
8075,8075,239,50,84,134
8076,8076,471,18,112,130
8077,8077,12,52,101,153
8078,8078,89,23,67,90
8079,8079,215,60,45,105
8080,8080,143,57,65,122
8081,8081,117,11,112,123
8082,8082,330,15,63,78
8083,8083,52,32,27,59
8084,8084,17,11,36,47
8085,8085,387,21,23,44
8086,8086,375,49,107,156
8087,8087,214,52,68,120
8088,8088,228,19,51,70
8089,8089,21,35,90,125
8090,8090,332,33,117,150
8091,8091,70,18,111,129
8092,8092,45,39,88,127
8093,8093,201,37,109,146
8094,8094,420,11,29,40
8095,8095,398,13,38,51
8096,8096,3,36,87,123
8097,8097,218,21,102,123
8098,8098,374,22,16,38
8099,8099,66,31,92,123
8100,8100,444,51,119,170
8101,8101,99,41,108,149
8102,8102,51,44,24,68
8103,8103,205,34,84,118
8104,8104,391,16,96,112
8105,8105,360,23,24,47
8106,8106,187,56,118,174
8107,8107,141,47,110,157
8108,8108,247,40,46,86
8109,8109,110,50,66,116
8110,8110,88,32,105,137
8111,8111,118,11,41,52
8112,8112,237,34,116,150
8113,8113,430,60,37,97
8114,8114,156,21,97,118
8115,8115,349,41,67,108
8116,8116,329,38,81,119
8117,8117,450,54,49,103
8118,8118,204,36,92,128
8119,8119,19,51,81,132
8120,8120,277,49,67,116
8121,8121,177,36,52,88
8122,8122,80,21,91,112
8123,8123,407,39,79,118
8124,8124,467,12,99,111
8125,8125,372,43,78,121
8126,8126,221,48,117,165
8127,8127,2,19,50,69
8128,8128,372,13,19,32
8129,8129,258,46,28,74
8130,8130,280,43,22,65
8131,8131,360,58,110,168
8132,8132,129,57,63,120
8133,8133,297,41,54,95
8134,8134,185,26,79,105
8135,8135,186,30,38,68
8136,8136,68,10,63,73
8137,8137,469,11,37,48
8138,8138,130,20,108,128
8139,8139,253,20,87,107
8140,8140,328,35,72,107
8141,8141,23,40,50,90
8142,8142,80,28,45,73
8143,8143,279,37,59,96
8144,8144,86,40,104,144
8145,8145,157,26,32,58
8146,8146,153,49,44,93
8147,8147,280,12,57,69
8148,8148,79,60,29,89
8149,8149,472,26,106,132
8150,8150,179,50,55,105
8151,8151,295,10,82,92
8152,8152,10,37,15,52
8153,8153,262,60,35,95
8154,8154,457,41,103,144
8155,8155,236,19,22,41
8156,8156,51,36,104,140
8157,8157,191,27,88,115
8158,8158,440,59,120,179
8159,8159,190,36,91,127
8160,8160,154,58,24,82
8161,8161,237,36,32,68
8162,8162,217,13,29,42
8163,8163,47,25,44,69
8164,8164,473,38,68,106
8165,8165,451,55,102,157
8166,8166,96,40,17,57
8167,8167,474,16,115,131
8168,8168,50,58,113,171
8169,8169,443,58,106,164
8170,8170,381,16,25,41
8171,8171,271,37,53,90
8172,8172,403,46,27,73
8173,8173,131,19,92,111
8174,8174,236,52,19,71
8175,8175,59,13,23,36
8176,8176,117,37,100,137
8177,8177,192,26,119,145
8178,8178,414,42,46,88
8179,8179,226,31,45,76
8180,8180,221,29,72,101
8181,8181,328,31,24,55
8182,8182,381,55,107,162
8183,8183,123,60,67,127
8184,8184,47,44,17,61
8185,8185,253,31,114,145
8186,8186,185,16,102,118
8187,8187,462,55,87,142
8188,8188,416,53,29,82
8189,8189,43,25,59,84
8190,8190,312,14,117,131
8191,8191,473,32,110,142
8192,8192,386,42,59,101
8193,8193,459,51,83,134
8194,8194,458,45,109,154
8195,8195,120,37,19,56
8196,8196,222,27,101,128
8197,8197,460,53,19,72
8198,8198,137,35,116,151
8199,8199,195,12,47,59
8200,8200,368,27,80,107
8201,8201,55,20,78,98
8202,8202,480,49,98,147
8203,8203,3,52,66,118
8204,8204,104,25,27,52
8205,8205,186,50,69,119
8206,8206,459,36,67,103
8207,8207,70,15,107,122
8208,8208,326,51,37,88
8209,8209,114,41,84,125
8210,8210,21,14,34,48
8211,8211,243,27,34,61
8212,8212,275,41,59,100
8213,8213,97,47,80,127
8214,8214,284,52,29,81
8215,8215,432,55,44,99
8216,8216,415,10,15,25
8217,8217,408,45,108,153
8218,8218,264,52,40,92
8219,8219,133,12,73,85
8220,8220,448,13,65,78
8221,8221,130,34,117,151
8222,8222,124,44,105,149
8223,8223,250,26,31,57
8224,8224,231,38,90,128
8225,8225,132,28,57,85
8226,8226,86,42,106,148
8227,8227,481,34,65,99
8228,8228,118,38,101,139
8229,8229,254,36,100,136
8230,8230,248,38,56,94
8231,8231,17,48,117,165
8232,8232,348,36,60,96
8233,8233,3,24,21,45
8234,8234,352,24,114,138
8235,8235,7,59,29,88
8236,8236,164,47,99,146
8237,8237,271,53,68,121
8238,8238,200,29,112,141
8239,8239,195,21,58,79
8240,8240,202,45,93,138
8241,8241,437,15,21,36
8242,8242,391,28,55,83
8243,8243,250,43,72,115
8244,8244,462,50,39,89
8245,8245,52,55,94,149
8246,8246,109,23,93,116
8247,8247,339,18,66,84
8248,8248,425,35,56,91
8249,8249,154,21,23,44
8250,8250,456,15,61,76
8251,8251,31,12,85,97
8252,8252,46,16,33,49
8253,8253,113,11,107,118
8254,8254,246,48,110,158
8255,8255,105,34,112,146
8256,8256,94,53,113,166
8257,8257,171,59,66,125
8258,8258,230,28,75,103
8259,8259,65,51,28,79
8260,8260,335,53,85,138
8261,8261,381,18,91,109
8262,8262,231,16,98,114
8263,8263,275,38,88,126
8264,8264,30,17,69,86
8265,8265,472,54,19,73
8266,8266,253,14,105,119
8267,8267,348,10,108,118
8268,8268,429,30,35,65
8269,8269,34,44,68,112
8270,8270,248,51,103,154
8271,8271,78,49,55,104
8272,8272,264,22,119,141
8273,8273,208,35,77,112
8274,8274,476,51,77,128
8275,8275,314,53,55,108
8276,8276,58,48,50,98
8277,8277,286,26,99,125
8278,8278,57,33,103,136
8279,8279,253,15,112,127
8280,8280,77,17,118,135
8281,8281,412,21,71,92
8282,8282,411,29,113,142
8283,8283,30,39,101,140
8284,8284,343,14,63,77
8285,8285,311,40,44,84
8286,8286,232,48,96,144
8287,8287,402,59,64,123
8288,8288,35,18,98,116
8289,8289,372,12,68,80
8290,8290,148,57,97,154
8291,8291,263,52,25,77
8292,8292,400,16,117,133
8293,8293,145,23,74,97
8294,8294,376,34,29,63
8295,8295,32,23,20,43
8296,8296,449,53,53,106
8297,8297,271,57,94,151
8298,8298,348,12,60,72
8299,8299,127,49,83,132
8300,8300,119,27,114,141
8301,8301,376,21,112,133
8302,8302,440,56,21,77
8303,8303,418,45,48,93
8304,8304,210,19,116,135
8305,8305,445,60,106,166
8306,8306,111,16,92,108
8307,8307,427,25,38,63
8308,8308,227,60,17,77
8309,8309,246,10,51,61
8310,8310,106,14,71,85
8311,8311,298,18,62,80
8312,8312,168,51,53,104
8313,8313,225,28,59,87
8314,8314,124,43,30,73
8315,8315,230,18,108,126
8316,8316,4,18,98,116
8317,8317,310,10,97,107
8318,8318,274,14,52,66
8319,8319,395,14,43,57
8320,8320,459,22,114,136
8321,8321,273,24,55,79
8322,8322,25,50,76,126
8323,8323,48,49,46,95
8324,8324,288,11,82,93
8325,8325,138,38,80,118
8326,8326,427,11,79,90
8327,8327,442,20,46,66
8328,8328,337,34,69,103
8329,8329,479,26,54,80
8330,8330,478,27,100,127
8331,8331,110,50,52,102
8332,8332,471,32,47,79
8333,8333,12,59,84,143
8334,8334,196,23,51,74
8335,8335,29,46,98,144
8336,8336,474,29,106,135
8337,8337,265,59,105,164
8338,8338,187,16,56,72
8339,8339,450,34,15,49
8340,8340,359,18,78,96
8341,8341,199,38,92,130
8342,8342,18,15,68,83
8343,8343,131,39,46,85
8344,8344,280,56,88,144
8345,8345,126,11,77,88
8346,8346,50,20,33,53
8347,8347,202,34,37,71
8348,8348,232,10,108,118
8349,8349,438,57,65,122
8350,8350,365,19,105,124
8351,8351,42,20,87,107
8352,8352,348,48,80,128
8353,8353,159,52,23,75
8354,8354,21,17,46,63
8355,8355,74,13,59,72
8356,8356,101,28,51,79
8357,8357,221,29,109,138
8358,8358,176,49,46,95
8359,8359,89,57,104,161
8360,8360,383,41,117,158
8361,8361,246,39,110,149
8362,8362,40,24,81,105
8363,8363,200,50,53,103
8364,8364,177,17,58,75
8365,8365,475,11,31,42
8366,8366,466,10,116,126
8367,8367,32,31,59,90
8368,8368,280,60,69,129
8369,8369,226,32,21,53
8370,8370,423,14,40,54
8371,8371,389,60,65,125
8372,8372,263,35,77,112
8373,8373,467,41,75,116
8374,8374,429,46,20,66
8375,8375,392,55,16,71
8376,8376,206,42,92,134
8377,8377,262,21,119,140
8378,8378,257,54,86,140
8379,8379,411,35,96,131
8380,8380,472,55,56,111
8381,8381,358,44,106,150
8382,8382,102,27,100,127
8383,8383,24,31,33,64
8384,8384,280,41,115,156
8385,8385,337,24,97,121
8386,8386,280,43,16,59
8387,8387,86,57,38,95
8388,8388,164,49,114,163
8389,8389,401,32,75,107
8390,8390,467,43,64,107
8391,8391,285,46,112,158
8392,8392,216,34,67,101
8393,8393,146,42,61,103
8394,8394,111,36,112,148
8395,8395,455,20,92,112
8396,8396,229,17,101,118
8397,8397,439,44,120,164
8398,8398,373,11,25,36
8399,8399,23,26,103,129
8400,8400,52,43,95,138
8401,8401,200,32,63,95
8402,8402,392,56,72,128
8403,8403,138,51,17,68
8404,8404,166,29,67,96
8405,8405,36,57,118,175
8406,8406,380,36,109,145
8407,8407,96,18,82,100
8408,8408,12,28,96,124
8409,8409,184,24,80,104
8410,8410,214,29,102,131
8411,8411,30,52,63,115
8412,8412,187,34,67,101
8413,8413,143,56,62,118
8414,8414,156,54,58,112
8415,8415,103,44,100,144
8416,8416,478,48,110,158
8417,8417,444,21,86,107
8418,8418,233,57,86,143
8419,8419,273,39,86,125
8420,8420,122,29,105,134
8421,8421,183,21,58,79
8422,8422,56,52,62,114
8423,8423,65,51,40,91
8424,8424,236,27,74,101
8425,8425,81,27,106,133
8426,8426,389,52,98,150
8427,8427,51,11,92,103
8428,8428,86,37,105,142
8429,8429,389,58,28,86
8430,8430,425,43,16,59
8431,8431,475,45,33,78
8432,8432,297,55,82,137
8433,8433,276,24,62,86
8434,8434,136,33,30,63
8435,8435,462,47,102,149
8436,8436,418,53,92,145
8437,8437,395,17,95,112
8438,8438,271,35,40,75
8439,8439,381,48,91,139
8440,8440,42,34,105,139
8441,8441,112,14,58,72
8442,8442,264,42,86,128
8443,8443,393,27,96,123
8444,8444,181,24,42,66
8445,8445,306,35,83,118
8446,8446,356,42,106,148
8447,8447,410,30,102,132
8448,8448,236,57,16,73
8449,8449,155,31,32,63
8450,8450,141,57,118,175
8451,8451,217,28,38,66
8452,8452,288,38,73,111
8453,8453,473,50,44,94
8454,8454,449,33,16,49
8455,8455,374,22,17,39
8456,8456,422,40,74,114
8457,8457,310,27,70,97
8458,8458,321,15,44,59
8459,8459,66,58,75,133
8460,8460,454,46,53,99
8461,8461,242,25,76,101
8462,8462,184,32,74,106
8463,8463,169,11,76,87
8464,8464,173,24,75,99
8465,8465,156,38,36,74
8466,8466,78,52,109,161
8467,8467,176,13,83,96
8468,8468,223,56,36,92
8469,8469,350,23,20,43
8470,8470,60,51,52,103
8471,8471,201,14,47,61
8472,8472,104,42,46,88
8473,8473,144,34,25,59
8474,8474,465,19,103,122
8475,8475,79,12,28,40
8476,8476,252,27,96,123
8477,8477,306,54,65,119
8478,8478,425,38,17,55
8479,8479,271,19,37,56
8480,8480,21,22,79,101
8481,8481,235,41,83,124
8482,8482,468,56,49,105
8483,8483,392,16,23,39
8484,8484,39,36,110,146
8485,8485,273,38,99,137
8486,8486,298,24,52,76
8487,8487,353,17,111,128
8488,8488,37,55,75,130
8489,8489,221,29,64,93
8490,8490,338,34,42,76
8491,8491,266,45,86,131
8492,8492,65,55,58,113
8493,8493,356,56,82,138
8494,8494,47,12,105,117
8495,8495,311,13,107,120
8496,8496,392,44,109,153
8497,8497,271,29,59,88
8498,8498,283,57,107,164
8499,8499,403,60,41,101
8500,8500,360,31,60,91
8501,8501,47,47,112,159
8502,8502,427,42,113,155
8503,8503,273,19,49,68
8504,8504,242,21,32,53
8505,8505,388,10,108,118
8506,8506,302,21,102,123
8507,8507,46,45,119,164
8508,8508,367,14,28,42
8509,8509,320,55,48,103
8510,8510,476,33,109,142
8511,8511,437,47,64,111
8512,8512,153,34,63,97
8513,8513,328,12,57,69
8514,8514,254,16,70,86
8515,8515,61,58,71,129
8516,8516,56,34,45,79
8517,8517,353,60,30,90
8518,8518,421,26,37,63
8519,8519,156,48,64,112
8520,8520,304,11,42,53
8521,8521,8,59,93,152
8522,8522,328,55,110,165
8523,8523,269,27,35,62
8524,8524,424,22,21,43
8525,8525,389,12,55,67
8526,8526,432,23,29,52
8527,8527,30,20,49,69
8528,8528,56,35,15,50
8529,8529,347,11,94,105
8530,8530,118,43,109,152
8531,8531,82,28,99,127
8532,8532,414,43,41,84
8533,8533,6,24,70,94
8534,8534,180,49,20,69
8535,8535,307,54,103,157
8536,8536,288,45,104,149
8537,8537,432,32,84,116
8538,8538,20,21,85,106
8539,8539,449,31,75,106
8540,8540,243,18,39,57
8541,8541,384,28,55,83
8542,8542,140,55,60,115
8543,8543,96,41,44,85
8544,8544,360,58,60,118
8545,8545,440,53,63,116
8546,8546,146,36,51,87
8547,8547,410,59,34,93
8548,8548,445,53,57,110
8549,8549,401,18,112,130
8550,8550,262,48,65,113
8551,8551,232,21,79,100
8552,8552,271,51,113,164
8553,8553,255,28,90,118
8554,8554,156,37,90,127
8555,8555,125,55,69,124
8556,8556,73,42,16,58
8557,8557,78,47,60,107
8558,8558,280,35,50,85
8559,8559,312,47,88,135
8560,8560,16,19,75,94
8561,8561,477,32,19,51
8562,8562,158,36,80,116
8563,8563,259,33,40,73
8564,8564,92,55,46,101
8565,8565,304,57,19,76
8566,8566,140,22,80,102
8567,8567,154,51,52,103
8568,8568,244,44,94,138
8569,8569,428,36,70,106
8570,8570,225,31,109,140
8571,8571,206,29,68,97
8572,8572,325,36,63,99
8573,8573,54,31,36,67
8574,8574,457,47,89,136
8575,8575,263,33,114,147
8576,8576,354,42,42,84
8577,8577,341,22,27,49
8578,8578,138,11,39,50
8579,8579,100,42,50,92
8580,8580,67,59,69,128
8581,8581,110,31,64,95
8582,8582,473,35,40,75
8583,8583,192,36,71,107
8584,8584,158,34,113,147
8585,8585,240,52,75,127
8586,8586,417,24,28,52
8587,8587,7,15,115,130
8588,8588,57,37,59,96
8589,8589,267,48,48,96
8590,8590,360,10,66,76
8591,8591,354,48,95,143
8592,8592,440,25,56,81
8593,8593,212,39,41,80
8594,8594,56,26,21,47
8595,8595,146,50,111,161
8596,8596,240,40,67,107
8597,8597,185,32,95,127
8598,8598,411,53,36,89
8599,8599,11,25,45,70
8600,8600,193,47,53,100
8601,8601,210,23,21,44
8602,8602,216,60,33,93
8603,8603,34,40,78,118
8604,8604,399,21,102,123
8605,8605,235,49,88,137
8606,8606,304,40,105,145
8607,8607,190,10,48,58
8608,8608,183,37,29,66
8609,8609,225,30,50,80
8610,8610,462,46,77,123
8611,8611,263,19,24,43
8612,8612,52,38,77,115
8613,8613,74,53,68,121
8614,8614,116,49,29,78
8615,8615,142,54,30,84
8616,8616,185,15,25,40
8617,8617,188,15,38,53
8618,8618,275,20,94,114
8619,8619,472,52,117,169
8620,8620,401,47,83,130
8621,8621,283,53,114,167
8622,8622,390,37,118,155
8623,8623,276,45,68,113
8624,8624,177,36,32,68
8625,8625,66,11,28,39
8626,8626,197,40,45,85
8627,8627,122,42,85,127
8628,8628,289,28,48,76
8629,8629,218,16,16,32
8630,8630,306,14,117,131
8631,8631,132,14,24,38
8632,8632,307,51,103,154
8633,8633,120,49,33,82
8634,8634,448,48,17,65
8635,8635,438,44,99,143
8636,8636,387,13,77,90
8637,8637,174,42,21,63
8638,8638,341,50,48,98
8639,8639,232,18,30,48
8640,8640,267,18,79,97
8641,8641,413,11,100,111
8642,8642,425,41,28,69
8643,8643,221,17,118,135
8644,8644,306,36,34,70
8645,8645,156,21,31,52
8646,8646,293,15,87,102
8647,8647,222,49,27,76
8648,8648,459,35,57,92
8649,8649,111,53,87,140
8650,8650,299,19,31,50
8651,8651,45,51,110,161
8652,8652,196,28,42,70
8653,8653,388,12,96,108
8654,8654,217,16,20,36
8655,8655,148,37,60,97
8656,8656,23,16,32,48
8657,8657,310,17,117,134
8658,8658,294,25,62,87
8659,8659,452,57,89,146
8660,8660,67,44,41,85
8661,8661,381,28,81,109
8662,8662,226,19,56,75
8663,8663,458,13,76,89
8664,8664,333,56,32,88
8665,8665,206,23,103,126
8666,8666,89,57,87,144
8667,8667,114,50,42,92
8668,8668,388,39,89,128
8669,8669,368,16,41,57
8670,8670,87,33,98,131
8671,8671,191,38,36,74
8672,8672,302,29,68,97
8673,8673,140,35,24,59
8674,8674,227,32,60,92
8675,8675,336,27,119,146
8676,8676,99,38,119,157
8677,8677,135,32,108,140
8678,8678,222,27,51,78
8679,8679,229,32,107,139
8680,8680,310,40,26,66
8681,8681,332,16,71,87
8682,8682,102,54,47,101
8683,8683,423,31,96,127
8684,8684,308,29,81,110
8685,8685,400,28,83,111
8686,8686,452,39,24,63
8687,8687,184,56,114,170
8688,8688,27,31,77,108
8689,8689,469,45,61,106
8690,8690,320,51,118,169
8691,8691,339,11,43,54
8692,8692,133,12,87,99
8693,8693,274,13,72,85
8694,8694,12,55,42,97
8695,8695,152,17,37,54
8696,8696,401,47,116,163
8697,8697,385,28,96,124
8698,8698,366,51,86,137
8699,8699,281,49,57,106
8700,8700,383,26,43,69
8701,8701,402,44,75,119
8702,8702,295,46,45,91
8703,8703,322,44,95,139
8704,8704,234,11,56,67
8705,8705,56,47,37,84
8706,8706,136,28,21,49
8707,8707,446,47,73,120
8708,8708,80,56,23,79
8709,8709,461,37,114,151
8710,8710,407,44,54,98
8711,8711,291,41,65,106
8712,8712,367,55,107,162
8713,8713,160,10,38,48
8714,8714,119,25,51,76
8715,8715,343,18,65,83
8716,8716,206,14,60,74
8717,8717,58,19,71,90
8718,8718,362,31,59,90
8719,8719,277,18,63,81
8720,8720,453,51,100,151
8721,8721,448,51,46,97
8722,8722,351,17,69,86
8723,8723,387,47,79,126
8724,8724,464,42,91,133
8725,8725,148,44,91,135
8726,8726,301,37,52,89
8727,8727,183,42,41,83
8728,8728,187,31,83,114
8729,8729,127,32,53,85
8730,8730,170,59,120,179
8731,8731,37,42,45,87
8732,8732,108,44,20,64
8733,8733,390,39,105,144
8734,8734,323,45,45,90
8735,8735,301,35,15,50
8736,8736,203,33,57,90
8737,8737,46,53,91,144
8738,8738,458,33,61,94
8739,8739,193,19,65,84
8740,8740,200,43,47,90
8741,8741,359,52,49,101
8742,8742,260,34,70,104
8743,8743,107,48,78,126
8744,8744,31,46,117,163
8745,8745,412,23,69,92
8746,8746,57,29,113,142
8747,8747,285,31,78,109
8748,8748,162,58,77,135
8749,8749,317,52,99,151
8750,8750,340,60,15,75
8751,8751,60,12,118,130
8752,8752,222,32,21,53
8753,8753,371,50,57,107
8754,8754,447,26,70,96
8755,8755,257,60,61,121
8756,8756,30,31,90,121
8757,8757,443,52,120,172
8758,8758,378,59,72,131
8759,8759,143,25,61,86
8760,8760,192,38,79,117
8761,8761,267,46,43,89
8762,8762,302,12,102,114
8763,8763,258,44,89,133
8764,8764,212,17,107,124
8765,8765,302,59,72,131
8766,8766,465,33,20,53
8767,8767,308,23,86,109
8768,8768,268,30,100,130
8769,8769,395,44,100,144
8770,8770,480,47,55,102
8771,8771,92,54,72,126
8772,8772,152,13,37,50
8773,8773,347,42,59,101
8774,8774,213,37,18,55
8775,8775,5,20,33,53
8776,8776,26,50,114,164
8777,8777,344,20,118,138
8778,8778,413,31,58,89
8779,8779,150,47,42,89
8780,8780,247,10,72,82
8781,8781,290,36,62,98
8782,8782,98,25,22,47
8783,8783,333,26,105,131
8784,8784,212,24,115,139
8785,8785,102,14,41,55
8786,8786,30,42,20,62
8787,8787,2,30,65,95
8788,8788,167,42,79,121
8789,8789,326,48,69,117
8790,8790,451,59,42,101
8791,8791,455,57,46,103
8792,8792,480,36,118,154
8793,8793,120,59,76,135
8794,8794,158,46,99,145
8795,8795,37,49,20,69
8796,8796,263,54,106,160
8797,8797,121,36,102,138
8798,8798,78,13,45,58
8799,8799,68,10,23,33
8800,8800,133,40,29,69
8801,8801,430,11,60,71
8802,8802,385,44,78,122
8803,8803,79,39,92,131
8804,8804,323,14,108,122
8805,8805,374,41,89,130
8806,8806,156,24,65,89
8807,8807,202,44,66,110
8808,8808,150,23,57,80
8809,8809,96,32,94,126
8810,8810,258,25,37,62
8811,8811,192,21,19,40
8812,8812,141,26,114,140
8813,8813,396,58,96,154
8814,8814,155,17,20,37
8815,8815,444,34,35,69
8816,8816,466,48,33,81
8817,8817,355,55,38,93
8818,8818,185,49,63,112
8819,8819,89,44,113,157
8820,8820,389,33,81,114
8821,8821,445,16,116,132
8822,8822,163,23,106,129
8823,8823,169,26,58,84
8824,8824,33,18,49,67
8825,8825,355,47,86,133
8826,8826,366,22,65,87
8827,8827,328,21,82,103
8828,8828,345,46,64,110
8829,8829,354,35,117,152
8830,8830,303,28,18,46
8831,8831,58,25,56,81
8832,8832,37,23,89,112
8833,8833,205,17,71,88
8834,8834,68,43,81,124
8835,8835,397,32,17,49
8836,8836,122,34,23,57
8837,8837,279,12,34,46
8838,8838,430,14,79,93
8839,8839,349,25,94,119
8840,8840,29,32,119,151
8841,8841,415,54,49,103
8842,8842,178,60,82,142
8843,8843,17,18,41,59
8844,8844,182,38,106,144
8845,8845,435,48,60,108
8846,8846,69,18,44,62
8847,8847,31,39,58,97
8848,8848,144,29,18,47
8849,8849,137,56,16,72
8850,8850,459,58,74,132
8851,8851,350,14,87,101
8852,8852,26,39,109,148
8853,8853,352,19,78,97
8854,8854,192,47,87,134
8855,8855,24,16,83,99
8856,8856,7,34,73,107
8857,8857,406,56,118,174
8858,8858,404,11,38,49
8859,8859,146,51,111,162
8860,8860,12,60,67,127
8861,8861,55,15,88,103
8862,8862,465,17,42,59
8863,8863,376,37,109,146
8864,8864,269,59,60,119
8865,8865,413,57,34,91
8866,8866,244,10,90,100
8867,8867,176,46,34,80
8868,8868,101,44,85,129
8869,8869,265,33,57,90
8870,8870,327,38,47,85
8871,8871,402,38,100,138
8872,8872,183,31,89,120
8873,8873,226,59,18,77
8874,8874,259,16,68,84
8875,8875,373,35,68,103
8876,8876,114,44,17,61
8877,8877,256,52,108,160
8878,8878,22,12,102,114
8879,8879,217,54,92,146
8880,8880,252,38,45,83
8881,8881,161,55,30,85
8882,8882,449,56,71,127
8883,8883,81,57,18,75
8884,8884,317,16,51,67
8885,8885,27,50,42,92
8886,8886,58,15,105,120
8887,8887,295,49,106,155
8888,8888,155,10,78,88
8889,8889,393,33,46,79
8890,8890,59,16,62,78
8891,8891,134,47,107,154
8892,8892,418,52,29,81
8893,8893,265,50,35,85
8894,8894,207,51,74,125
8895,8895,417,45,92,137
8896,8896,442,29,42,71
8897,8897,105,35,39,74
8898,8898,40,25,84,109
8899,8899,118,28,61,89
8900,8900,481,45,46,91
8901,8901,34,32,52,84
8902,8902,83,33,21,54
8903,8903,371,29,97,126
8904,8904,389,25,61,86
8905,8905,209,58,23,81
8906,8906,407,21,82,103
8907,8907,261,11,75,86
8908,8908,357,30,32,62
8909,8909,481,43,107,150
8910,8910,470,49,110,159
8911,8911,6,40,88,128
8912,8912,331,44,61,105
8913,8913,393,53,86,139
8914,8914,372,41,69,110
8915,8915,273,37,119,156
8916,8916,297,10,103,113
8917,8917,361,13,40,53
8918,8918,357,34,77,111
8919,8919,27,34,37,71
8920,8920,348,35,118,153
8921,8921,211,26,28,54
8922,8922,479,23,53,76
8923,8923,316,16,90,106
8924,8924,399,22,25,47
8925,8925,88,54,101,155
8926,8926,449,16,36,52
8927,8927,331,30,94,124
8928,8928,267,18,32,50
8929,8929,109,18,110,128
8930,8930,268,57,82,139
8931,8931,176,28,75,103
8932,8932,386,47,43,90
8933,8933,322,55,25,80
8934,8934,265,60,50,110
8935,8935,175,31,98,129
8936,8936,361,22,18,40
8937,8937,82,30,66,96
8938,8938,49,54,87,141
8939,8939,384,43,106,149
8940,8940,95,53,100,153
8941,8941,205,39,86,125
8942,8942,38,21,57,78
8943,8943,320,40,54,94
8944,8944,330,16,16,32
8945,8945,354,39,30,69
8946,8946,365,22,38,60
8947,8947,396,48,82,130
8948,8948,123,41,65,106
8949,8949,250,56,49,105
8950,8950,207,15,18,33
8951,8951,38,36,19,55
8952,8952,456,58,65,123
8953,8953,105,48,106,154
8954,8954,400,60,116,176
8955,8955,10,46,87,133
8956,8956,190,30,108,138
8957,8957,74,35,83,118
8958,8958,354,56,90,146
8959,8959,301,19,49,68
8960,8960,454,39,49,88
8961,8961,133,26,79,105
8962,8962,72,25,65,90
8963,8963,298,34,102,136
8964,8964,95,28,41,69
8965,8965,347,22,49,71
8966,8966,416,49,25,74
8967,8967,362,23,27,50
8968,8968,60,21,91,112
8969,8969,209,56,54,110
8970,8970,139,41,54,95
8971,8971,375,15,19,34
8972,8972,133,22,87,109
8973,8973,28,27,76,103
8974,8974,158,51,18,69
8975,8975,279,52,114,166
8976,8976,299,45,86,131
8977,8977,348,52,75,127
8978,8978,383,47,52,99
8979,8979,312,44,117,161
8980,8980,226,32,34,66
8981,8981,408,57,81,138
8982,8982,223,29,87,116
8983,8983,35,58,80,138
8984,8984,238,46,103,149
8985,8985,392,46,110,156
8986,8986,345,18,96,114
8987,8987,33,50,75,125
8988,8988,293,58,20,78
8989,8989,418,27,52,79
8990,8990,171,33,68,101
8991,8991,460,30,58,88
8992,8992,136,47,94,141
8993,8993,47,46,85,131
8994,8994,280,11,64,75
8995,8995,389,26,58,84
8996,8996,472,42,88,130
8997,8997,315,55,83,138
8998,8998,52,12,69,81
8999,8999,108,37,38,75
9000,9000,352,58,89,147
9001,9001,126,42,99,141
9002,9002,397,59,43,102
9003,9003,258,54,70,124
9004,9004,242,49,27,76
9005,9005,263,17,24,41
9006,9006,144,50,42,92
9007,9007,300,26,119,145
9008,9008,194,29,30,59
9009,9009,29,11,75,86
9010,9010,396,28,117,145
9011,9011,427,49,112,161
9012,9012,441,52,61,113
9013,9013,18,49,65,114
9014,9014,179,24,93,117
9015,9015,230,54,54,108
9016,9016,30,32,36,68
9017,9017,138,33,70,103
9018,9018,481,45,29,74
9019,9019,34,59,62,121
9020,9020,234,30,67,97
9021,9021,155,26,46,72
9022,9022,368,27,110,137
9023,9023,54,30,82,112
9024,9024,228,60,21,81
9025,9025,231,17,84,101
9026,9026,24,44,97,141
9027,9027,178,33,23,56
9028,9028,154,47,61,108
9029,9029,224,58,46,104
9030,9030,281,40,85,125
9031,9031,215,43,55,98
9032,9032,296,44,34,78
9033,9033,356,25,62,87
9034,9034,60,41,33,74
9035,9035,202,26,107,133
9036,9036,92,22,47,69
9037,9037,83,53,42,95
9038,9038,225,50,46,96
9039,9039,312,21,70,91
9040,9040,100,49,79,128
9041,9041,330,13,92,105
9042,9042,3,60,120,180
9043,9043,124,52,42,94
9044,9044,71,19,109,128
9045,9045,156,37,95,132
9046,9046,61,11,105,116
9047,9047,172,56,23,79
9048,9048,397,36,57,93
9049,9049,58,44,28,72
9050,9050,111,35,61,96
9051,9051,233,38,48,86
9052,9052,79,16,37,53
9053,9053,103,35,82,117
9054,9054,46,32,81,113
9055,9055,61,53,63,116
9056,9056,209,39,33,72
9057,9057,207,20,111,131
9058,9058,295,59,46,105
9059,9059,434,58,61,119
9060,9060,169,53,17,70
9061,9061,255,37,52,89
9062,9062,449,44,67,111
9063,9063,291,33,83,116
9064,9064,71,13,119,132
9065,9065,324,13,41,54
9066,9066,270,26,75,101
9067,9067,444,31,108,139
9068,9068,362,46,100,146
9069,9069,320,27,22,49
9070,9070,217,51,25,76
9071,9071,402,20,35,55
9072,9072,258,24,46,70
9073,9073,291,13,67,80
9074,9074,53,13,51,64
9075,9075,466,26,82,108
9076,9076,9,47,64,111
9077,9077,475,54,114,168
9078,9078,448,15,38,53
9079,9079,319,27,98,125
9080,9080,223,16,45,61
9081,9081,38,60,34,94
9082,9082,357,22,106,128
9083,9083,43,52,96,148
9084,9084,359,20,28,48
9085,9085,286,39,90,129
9086,9086,254,21,98,119
9087,9087,224,10,38,48
9088,9088,342,17,112,129
9089,9089,405,44,51,95
9090,9090,109,20,48,68
9091,9091,190,22,96,118
9092,9092,374,13,32,45
9093,9093,326,60,90,150
9094,9094,407,53,76,129
9095,9095,254,16,52,68
9096,9096,276,53,75,128
9097,9097,284,58,65,123
9098,9098,439,31,58,89
9099,9099,416,24,103,127
9100,9100,176,28,67,95
9101,9101,235,45,107,152
9102,9102,376,39,56,95
9103,9103,228,35,32,67
9104,9104,399,31,115,146
9105,9105,405,23,90,113
9106,9106,261,18,112,130
9107,9107,456,24,54,78
9108,9108,279,52,37,89
9109,9109,356,30,60,90
9110,9110,410,24,119,143
9111,9111,75,48,24,72
9112,9112,26,29,87,116
9113,9113,282,19,47,66
9114,9114,281,23,66,89
9115,9115,194,37,23,60
9116,9116,98,10,79,89
9117,9117,430,12,36,48
9118,9118,45,32,19,51
9119,9119,33,51,34,85
9120,9120,271,28,52,80
9121,9121,406,57,113,170
9122,9122,381,22,103,125
9123,9123,214,28,90,118
9124,9124,177,36,61,97
9125,9125,281,20,108,128
9126,9126,93,39,47,86
9127,9127,160,20,21,41
9128,9128,8,37,37,74
9129,9129,78,55,50,105
9130,9130,80,33,77,110
9131,9131,221,53,63,116
9132,9132,208,26,101,127
9133,9133,171,17,27,44
9134,9134,44,31,39,70
9135,9135,175,30,18,48
9136,9136,53,19,15,34
9137,9137,453,15,28,43
9138,9138,296,11,76,87
9139,9139,394,53,35,88
9140,9140,96,58,101,159
9141,9141,82,60,110,170
9142,9142,402,60,44,104
9143,9143,361,50,37,87
9144,9144,94,56,119,175
9145,9145,433,41,39,80
9146,9146,278,11,74,85
9147,9147,280,27,98,125
9148,9148,308,36,61,97
9149,9149,57,43,114,157
9150,9150,77,36,29,65
9151,9151,68,38,44,82
9152,9152,323,11,41,52
9153,9153,470,28,65,93
9154,9154,272,25,83,108
9155,9155,182,39,97,136
9156,9156,453,39,83,122
9157,9157,286,44,64,108
9158,9158,358,38,43,81
9159,9159,116,28,79,107
9160,9160,387,22,25,47
9161,9161,236,49,73,122
9162,9162,352,59,54,113
9163,9163,416,53,95,148
9164,9164,124,41,104,145
9165,9165,388,35,62,97
9166,9166,21,35,35,70
9167,9167,51,29,22,51
9168,9168,337,22,47,69
9169,9169,389,59,119,178
9170,9170,244,29,27,56
9171,9171,127,19,42,61
9172,9172,100,37,101,138
9173,9173,146,17,83,100
9174,9174,414,46,114,160
9175,9175,346,40,53,93
9176,9176,475,17,82,99
9177,9177,180,51,32,83
9178,9178,452,23,99,122
9179,9179,29,41,55,96
9180,9180,75,56,74,130
9181,9181,244,43,104,147
9182,9182,252,27,68,95
9183,9183,118,25,42,67
9184,9184,342,34,74,108
9185,9185,189,49,103,152
9186,9186,205,44,71,115
9187,9187,365,27,87,114
9188,9188,101,35,54,89
9189,9189,384,38,48,86
9190,9190,386,48,79,127
9191,9191,297,24,63,87
9192,9192,264,29,117,146
9193,9193,271,38,57,95
9194,9194,144,60,34,94
9195,9195,432,25,23,48
9196,9196,466,51,118,169
9197,9197,297,47,75,122
9198,9198,390,24,86,110
9199,9199,151,41,21,62
9200,9200,144,12,67,79
9201,9201,263,19,58,77
9202,9202,50,56,53,109
9203,9203,262,11,116,127
9204,9204,68,25,42,67
9205,9205,300,19,26,45
9206,9206,450,28,82,110
9207,9207,408,59,95,154
9208,9208,451,35,79,114
9209,9209,28,38,95,133
9210,9210,174,58,65,123
9211,9211,122,58,22,80
9212,9212,324,25,55,80
9213,9213,95,33,83,116
9214,9214,143,41,114,155
9215,9215,135,15,31,46
9216,9216,269,45,112,157
9217,9217,331,34,113,147
9218,9218,418,39,39,78
9219,9219,114,28,73,101
9220,9220,78,56,103,159
9221,9221,97,50,72,122
9222,9222,476,55,75,130
9223,9223,255,49,65,114
9224,9224,90,28,87,115
9225,9225,204,30,117,147
9226,9226,438,59,37,96
9227,9227,92,15,40,55
9228,9228,21,56,119,175
9229,9229,477,50,35,85
9230,9230,160,42,88,130
9231,9231,179,29,99,128
9232,9232,134,45,29,74
9233,9233,368,44,81,125
9234,9234,307,25,60,85
9235,9235,303,45,82,127
9236,9236,362,12,70,82
9237,9237,401,51,46,97
9238,9238,295,23,36,59
9239,9239,54,17,56,73
9240,9240,36,50,62,112
9241,9241,129,50,77,127
9242,9242,473,57,70,127
9243,9243,480,42,112,154
9244,9244,161,46,70,116
9245,9245,340,16,48,64
9246,9246,268,16,107,123
9247,9247,171,25,59,84
9248,9248,206,56,116,172
9249,9249,291,11,97,108
9250,9250,429,20,59,79
9251,9251,459,39,102,141
9252,9252,176,43,113,156
9253,9253,236,47,105,152
9254,9254,186,22,78,100
9255,9255,337,37,120,157
9256,9256,255,10,33,43
9257,9257,456,18,77,95
9258,9258,323,48,99,147
9259,9259,281,49,114,163
9260,9260,398,31,15,46
9261,9261,154,12,71,83
9262,9262,64,54,41,95
9263,9263,474,29,73,102
9264,9264,163,35,56,91
9265,9265,88,56,59,115
9266,9266,12,16,17,33
9267,9267,154,16,78,94
9268,9268,435,27,54,81
9269,9269,453,13,44,57
9270,9270,18,51,119,170
9271,9271,96,55,103,158
9272,9272,182,39,40,79
9273,9273,120,18,55,73
9274,9274,279,59,110,169
9275,9275,137,12,53,65
9276,9276,246,21,103,124
9277,9277,85,42,47,89
9278,9278,173,35,52,87
9279,9279,302,30,89,119
9280,9280,234,34,113,147
9281,9281,193,49,120,169
9282,9282,109,46,65,111
9283,9283,177,60,65,125
9284,9284,285,28,72,100
9285,9285,196,50,53,103
9286,9286,379,55,95,150
9287,9287,474,51,100,151
9288,9288,159,37,78,115
9289,9289,95,58,56,114
9290,9290,168,29,38,67
9291,9291,184,20,108,128
9292,9292,18,46,105,151
9293,9293,216,43,43,86
9294,9294,225,40,25,65
9295,9295,259,15,83,98
9296,9296,247,45,53,98
9297,9297,257,49,98,147
9298,9298,83,18,56,74
9299,9299,355,13,67,80
9300,9300,146,59,62,121
9301,9301,303,51,43,94
9302,9302,77,35,81,116
9303,9303,301,21,112,133
9304,9304,45,20,33,53
9305,9305,297,45,84,129
9306,9306,171,54,113,167
9307,9307,235,24,67,91
9308,9308,198,18,84,102
9309,9309,318,18,40,58
9310,9310,453,42,104,146
9311,9311,412,48,99,147
9312,9312,350,60,42,102
9313,9313,308,12,107,119
9314,9314,428,52,113,165
9315,9315,381,17,30,47
9316,9316,25,36,47,83
9317,9317,82,48,100,148
9318,9318,446,24,78,102
9319,9319,155,14,56,70
9320,9320,30,38,105,143
9321,9321,432,29,84,113
9322,9322,39,18,105,123
9323,9323,323,53,26,79
9324,9324,260,37,66,103
9325,9325,109,22,27,49
9326,9326,80,49,25,74
9327,9327,390,25,113,138
9328,9328,458,28,42,70
9329,9329,186,32,88,120
9330,9330,442,49,54,103
9331,9331,109,38,91,129
9332,9332,437,19,25,44
9333,9333,301,33,83,116
9334,9334,325,21,49,70
9335,9335,444,32,119,151
9336,9336,326,39,24,63
9337,9337,430,16,47,63
9338,9338,130,47,104,151
9339,9339,69,14,86,100
9340,9340,100,43,110,153
9341,9341,33,20,30,50
9342,9342,462,23,73,96
9343,9343,276,54,100,154
9344,9344,64,54,30,84
9345,9345,389,33,97,130
9346,9346,304,44,16,60
9347,9347,80,20,29,49
9348,9348,136,51,114,165
9349,9349,192,24,57,81
9350,9350,100,14,88,102
9351,9351,98,47,69,116
9352,9352,271,19,27,46
9353,9353,382,36,41,77
9354,9354,10,16,17,33
9355,9355,52,20,98,118
9356,9356,174,42,115,157
9357,9357,474,15,27,42
9358,9358,474,50,107,157
9359,9359,204,46,50,96
9360,9360,445,52,41,93
9361,9361,161,10,106,116
9362,9362,17,28,48,76
9363,9363,215,24,90,114
9364,9364,224,50,113,163
9365,9365,434,11,80,91
9366,9366,397,16,38,54
9367,9367,192,44,98,142
9368,9368,78,52,33,85
9369,9369,24,19,70,89
9370,9370,309,34,20,54
9371,9371,122,53,82,135
9372,9372,366,19,86,105
9373,9373,382,10,99,109
9374,9374,199,37,21,58
9375,9375,102,18,30,48
9376,9376,299,41,45,86
9377,9377,382,34,119,153
9378,9378,322,27,57,84
9379,9379,247,53,46,99
9380,9380,312,36,119,155
9381,9381,89,57,36,93
9382,9382,291,21,78,99
9383,9383,242,21,77,98
9384,9384,142,35,115,150
9385,9385,310,53,101,154
9386,9386,360,32,72,104
9387,9387,366,51,90,141
9388,9388,6,30,32,62
9389,9389,330,31,99,130
9390,9390,60,57,72,129
9391,9391,359,57,56,113
9392,9392,320,22,79,101
9393,9393,60,37,105,142
9394,9394,46,42,109,151
9395,9395,375,59,80,139
9396,9396,451,60,103,163
9397,9397,142,19,104,123
9398,9398,30,15,112,127
9399,9399,125,45,84,129
9400,9400,179,19,26,45
9401,9401,315,45,66,111
9402,9402,205,34,87,121
9403,9403,54,57,64,121
9404,9404,39,10,111,121
9405,9405,182,48,86,134
9406,9406,248,14,105,119
9407,9407,458,11,92,103
9408,9408,441,11,80,91
9409,9409,99,43,38,81
9410,9410,104,56,53,109
9411,9411,416,40,83,123
9412,9412,392,24,49,73
9413,9413,63,60,77,137
9414,9414,171,33,93,126
9415,9415,152,19,112,131
9416,9416,182,22,25,47
9417,9417,394,27,117,144
9418,9418,121,36,29,65
9419,9419,395,16,96,112
9420,9420,441,30,102,132
9421,9421,388,14,107,121
9422,9422,433,60,43,103
9423,9423,126,11,42,53
9424,9424,203,18,45,63
9425,9425,73,46,61,107
9426,9426,102,26,31,57
9427,9427,77,38,75,113
9428,9428,307,15,88,103
9429,9429,293,25,89,114
9430,9430,149,37,26,63
9431,9431,326,28,39,67
9432,9432,447,44,115,159
9433,9433,466,56,82,138
9434,9434,131,49,87,136
9435,9435,278,33,75,108
9436,9436,137,34,53,87
9437,9437,410,13,120,133
9438,9438,226,17,33,50
9439,9439,15,35,58,93
9440,9440,121,19,36,55
9441,9441,162,40,109,149
9442,9442,303,49,119,168
9443,9443,216,28,47,75
9444,9444,98,55,71,126
9445,9445,190,60,56,116
9446,9446,440,35,68,103
9447,9447,286,36,120,156
9448,9448,115,54,15,69
9449,9449,147,39,72,111
9450,9450,459,26,31,57
9451,9451,80,48,81,129
9452,9452,156,48,30,78
9453,9453,70,14,99,113
9454,9454,439,27,71,98
9455,9455,49,40,68,108
9456,9456,472,22,91,113
9457,9457,150,37,117,154
9458,9458,28,58,72,130
9459,9459,72,17,92,109
9460,9460,279,32,18,50
9461,9461,252,14,62,76
9462,9462,313,13,98,111
9463,9463,89,52,20,72
9464,9464,188,18,59,77
9465,9465,361,48,27,75
9466,9466,190,14,96,110
9467,9467,270,18,114,132
9468,9468,474,25,63,88
9469,9469,146,16,60,76
9470,9470,432,15,60,75
9471,9471,356,17,105,122
9472,9472,417,52,43,95
9473,9473,477,39,75,114
9474,9474,319,10,92,102
9475,9475,257,21,88,109
9476,9476,164,47,39,86
9477,9477,405,13,37,50
9478,9478,317,50,72,122
9479,9479,169,57,76,133
9480,9480,251,58,45,103
9481,9481,294,22,70,92
9482,9482,278,46,26,72
9483,9483,44,29,18,47
9484,9484,88,12,74,86
9485,9485,132,27,105,132
9486,9486,276,47,99,146
9487,9487,106,33,107,140
9488,9488,161,33,40,73
9489,9489,277,30,55,85
9490,9490,4,14,52,66
9491,9491,86,46,108,154
9492,9492,241,17,62,79
9493,9493,186,44,106,150
9494,9494,110,51,55,106
9495,9495,319,28,41,69
9496,9496,460,37,48,85
9497,9497,242,28,115,143
9498,9498,258,13,116,129
9499,9499,15,56,38,94
9500,9500,393,55,54,109
9501,9501,427,38,18,56
9502,9502,328,10,105,115
9503,9503,304,11,22,33
9504,9504,350,10,55,65
9505,9505,401,30,24,54
9506,9506,24,40,85,125
9507,9507,66,48,58,106
9508,9508,256,57,20,77
9509,9509,63,17,62,79
9510,9510,440,52,105,157
9511,9511,278,55,97,152
9512,9512,178,44,118,162
9513,9513,469,11,32,43
9514,9514,306,55,34,89
9515,9515,335,39,18,57
9516,9516,19,50,115,165
9517,9517,458,50,38,88
9518,9518,236,32,94,126
9519,9519,203,27,53,80
9520,9520,119,16,83,99
9521,9521,288,39,93,132
9522,9522,326,15,103,118
9523,9523,224,26,60,86
9524,9524,320,41,53,94
9525,9525,57,40,60,100
9526,9526,2,54,98,152
9527,9527,420,13,80,93
9528,9528,402,54,69,123
9529,9529,348,20,109,129
9530,9530,461,60,53,113
9531,9531,269,18,114,132
9532,9532,324,19,110,129
9533,9533,4,25,51,76
9534,9534,101,21,57,78
9535,9535,272,16,79,95
9536,9536,261,42,26,68
9537,9537,331,12,81,93
9538,9538,284,54,112,166
9539,9539,41,24,16,40
9540,9540,329,13,20,33
9541,9541,196,10,64,74
9542,9542,308,57,47,104
9543,9543,223,21,56,77
9544,9544,479,15,21,36
9545,9545,2,24,17,41
9546,9546,334,19,32,51
9547,9547,309,28,92,120
9548,9548,193,60,17,77
9549,9549,402,41,66,107
9550,9550,312,53,18,71
9551,9551,340,57,86,143
9552,9552,46,41,109,150
9553,9553,319,55,98,153
9554,9554,130,32,104,136
9555,9555,35,58,88,146
9556,9556,370,46,75,121
9557,9557,57,16,71,87
9558,9558,468,54,116,170
9559,9559,403,59,43,102
9560,9560,50,34,35,69
9561,9561,241,26,30,56
9562,9562,186,60,120,180
9563,9563,364,40,84,124
9564,9564,396,28,103,131
9565,9565,85,19,89,108
9566,9566,175,19,78,97
9567,9567,53,57,69,126
9568,9568,350,45,93,138
9569,9569,52,41,44,85
9570,9570,73,55,69,124
9571,9571,213,53,27,80
9572,9572,201,23,79,102
9573,9573,158,18,24,42
9574,9574,215,20,65,85
9575,9575,6,39,34,73
9576,9576,286,25,89,114
9577,9577,81,10,56,66
9578,9578,281,21,76,97
9579,9579,169,48,120,168
9580,9580,39,17,66,83
9581,9581,398,41,85,126
9582,9582,128,20,55,75
9583,9583,253,52,89,141
9584,9584,414,34,27,61
9585,9585,391,35,52,87
9586,9586,18,35,42,77
9587,9587,11,40,47,87
9588,9588,155,33,88,121
9589,9589,295,14,41,55
9590,9590,252,13,60,73
9591,9591,10,56,92,148
9592,9592,430,30,28,58
9593,9593,270,40,28,68
9594,9594,468,42,22,64
9595,9595,401,38,113,151
9596,9596,420,50,33,83
9597,9597,210,12,32,44
9598,9598,54,11,36,47
9599,9599,126,13,61,74
9600,9600,384,59,76,135
9601,9601,349,59,95,154
9602,9602,246,52,28,80
9603,9603,349,39,41,80
9604,9604,61,43,73,116
9605,9605,214,58,85,143
9606,9606,102,38,109,147
9607,9607,280,60,117,177
9608,9608,115,17,49,66
9609,9609,246,58,108,166
9610,9610,91,55,79,134
9611,9611,447,18,52,70
9612,9612,226,10,102,112
9613,9613,417,17,113,130
9614,9614,206,37,40,77
9615,9615,431,39,102,141
9616,9616,26,55,26,81
9617,9617,45,12,71,83
9618,9618,264,29,98,127
9619,9619,146,53,109,162
9620,9620,224,42,35,77
9621,9621,179,13,95,108
9622,9622,15,47,85,132
9623,9623,333,22,45,67
9624,9624,109,10,20,30
9625,9625,351,43,95,138
9626,9626,276,18,51,69
9627,9627,420,58,71,129
9628,9628,200,18,36,54
9629,9629,226,35,16,51
9630,9630,348,27,58,85
9631,9631,188,39,31,70
9632,9632,161,38,51,89
9633,9633,250,57,57,114
9634,9634,294,18,75,93
9635,9635,108,34,18,52
9636,9636,96,42,25,67
9637,9637,239,43,21,64
9638,9638,279,43,83,126
9639,9639,423,43,104,147
9640,9640,13,59,78,137
9641,9641,243,52,109,161
9642,9642,396,29,40,69
9643,9643,360,24,113,137
9644,9644,228,23,43,66
9645,9645,289,21,70,91
9646,9646,135,41,15,56
9647,9647,199,21,120,141
9648,9648,11,15,79,94
9649,9649,91,60,37,97
9650,9650,243,56,59,115
9651,9651,423,37,35,72
9652,9652,216,50,82,132
9653,9653,454,11,23,34
9654,9654,18,37,92,129
9655,9655,108,24,106,130
9656,9656,377,60,63,123
9657,9657,240,57,101,158
9658,9658,53,42,95,137
9659,9659,264,46,104,150
9660,9660,407,38,92,130
9661,9661,407,23,32,55
9662,9662,53,13,78,91
9663,9663,211,31,21,52
9664,9664,40,36,111,147
9665,9665,428,59,41,100
9666,9666,143,35,20,55
9667,9667,400,51,113,164
9668,9668,361,27,44,71
9669,9669,239,23,27,50
9670,9670,447,39,55,94
9671,9671,79,22,105,127
9672,9672,92,39,40,79
9673,9673,15,40,69,109
9674,9674,205,54,68,122
9675,9675,111,48,47,95
9676,9676,160,46,74,120
9677,9677,102,51,33,84
9678,9678,472,19,47,66
9679,9679,207,38,50,88
9680,9680,69,13,59,72
9681,9681,391,38,58,96
9682,9682,106,29,59,88
9683,9683,202,22,42,64
9684,9684,81,59,60,119
9685,9685,399,54,115,169
9686,9686,66,53,75,128
9687,9687,426,20,86,106
9688,9688,437,40,90,130
9689,9689,386,37,54,91
9690,9690,207,12,114,126
9691,9691,479,44,49,93
9692,9692,271,25,86,111
9693,9693,449,44,45,89
9694,9694,323,34,109,143
9695,9695,403,55,87,142
9696,9696,240,31,103,134
9697,9697,279,42,24,66
9698,9698,306,29,42,71
9699,9699,231,53,17,70
9700,9700,103,53,97,150
9701,9701,334,57,105,162
9702,9702,400,39,52,91
9703,9703,197,49,70,119
9704,9704,280,40,67,107
9705,9705,72,18,49,67
9706,9706,16,10,23,33
9707,9707,214,32,82,114
9708,9708,233,27,35,62
9709,9709,23,20,98,118
9710,9710,12,23,86,109
9711,9711,372,32,84,116
9712,9712,282,20,33,53
9713,9713,90,21,80,101
9714,9714,458,32,52,84
9715,9715,89,40,35,75
9716,9716,3,15,15,30
9717,9717,108,54,115,169
9718,9718,15,41,97,138
9719,9719,127,15,15,30
9720,9720,362,43,40,83
9721,9721,160,60,109,169
9722,9722,440,20,85,105
9723,9723,61,15,95,110
9724,9724,40,36,82,118
9725,9725,22,47,56,103
9726,9726,416,31,64,95
9727,9727,397,35,23,58
9728,9728,143,55,100,155
9729,9729,320,29,24,53
9730,9730,1,30,58,88
9731,9731,261,13,86,99
9732,9732,210,42,114,156
9733,9733,25,28,29,57
9734,9734,267,43,46,89
9735,9735,200,51,20,71
9736,9736,10,43,118,161
9737,9737,128,52,85,137
9738,9738,194,23,83,106
9739,9739,238,26,108,134
9740,9740,69,39,57,96
9741,9741,145,60,113,173
9742,9742,302,26,69,95
9743,9743,79,46,28,74
9744,9744,261,27,25,52
9745,9745,210,14,51,65
9746,9746,238,57,92,149
9747,9747,159,19,105,124
9748,9748,266,18,73,91
9749,9749,163,15,21,36
9750,9750,272,36,108,144
9751,9751,306,17,86,103
9752,9752,34,45,98,143
9753,9753,40,26,53,79
9754,9754,157,10,109,119
9755,9755,300,15,37,52
9756,9756,420,38,58,96
9757,9757,435,34,91,125
9758,9758,198,38,66,104
9759,9759,168,14,85,99
9760,9760,36,22,63,85
9761,9761,474,14,47,61
9762,9762,264,41,55,96
9763,9763,380,53,110,163
9764,9764,94,59,60,119
9765,9765,454,56,57,113
9766,9766,150,15,18,33
9767,9767,374,22,45,67
9768,9768,143,21,112,133
9769,9769,22,38,99,137
9770,9770,231,34,78,112
9771,9771,192,48,104,152
9772,9772,192,25,59,84
9773,9773,347,16,17,33
9774,9774,395,45,95,140
9775,9775,301,12,97,109
9776,9776,328,56,29,85
9777,9777,379,42,101,143
9778,9778,232,15,94,109
9779,9779,9,23,119,142
9780,9780,361,16,39,55
9781,9781,481,26,27,53
9782,9782,359,48,87,135
9783,9783,415,50,45,95
9784,9784,53,51,109,160
9785,9785,396,51,95,146
9786,9786,332,58,117,175
9787,9787,105,51,40,91
9788,9788,129,13,65,78
9789,9789,46,48,89,137
9790,9790,423,36,77,113
9791,9791,467,59,96,155
9792,9792,294,51,31,82
9793,9793,232,60,49,109
9794,9794,176,57,48,105
9795,9795,115,60,116,176
9796,9796,244,42,75,117
9797,9797,452,28,41,69
9798,9798,457,27,112,139
9799,9799,385,16,54,70
9800,9800,160,25,96,121
9801,9801,273,38,107,145
9802,9802,270,45,34,79
9803,9803,30,25,98,123
9804,9804,73,40,99,139
9805,9805,216,26,114,140
9806,9806,336,56,91,147
9807,9807,260,17,89,106
9808,9808,173,12,55,67
9809,9809,442,10,16,26
9810,9810,290,19,21,40
9811,9811,64,45,84,129
9812,9812,49,32,58,90
9813,9813,371,20,112,132
9814,9814,120,38,51,89
9815,9815,5,20,119,139
9816,9816,309,28,40,68
9817,9817,397,39,74,113
9818,9818,391,27,34,61
9819,9819,97,50,84,134
9820,9820,327,54,43,97
9821,9821,272,10,104,114
9822,9822,317,56,33,89
9823,9823,184,11,88,99
9824,9824,343,60,104,164
9825,9825,235,48,54,102
9826,9826,263,58,114,172
9827,9827,431,23,68,91
9828,9828,323,21,46,67
9829,9829,201,29,29,58
9830,9830,304,21,68,89
9831,9831,407,56,109,165
9832,9832,183,55,39,94
9833,9833,312,52,68,120
9834,9834,434,26,85,111
9835,9835,86,22,91,113
9836,9836,218,43,104,147
9837,9837,21,12,60,72
9838,9838,376,57,94,151
9839,9839,268,23,77,100
9840,9840,30,15,100,115
9841,9841,206,33,40,73
9842,9842,465,30,40,70
9843,9843,5,17,97,114
9844,9844,348,12,22,34
9845,9845,50,14,23,37
9846,9846,374,22,25,47
9847,9847,367,18,28,46
9848,9848,453,18,44,62
9849,9849,413,59,57,116
9850,9850,108,22,101,123
9851,9851,142,23,26,49
9852,9852,115,43,21,64
9853,9853,192,25,82,107
9854,9854,265,32,89,121
9855,9855,402,20,119,139
9856,9856,7,43,44,87
9857,9857,104,26,84,110
9858,9858,41,53,40,93
9859,9859,250,24,77,101
9860,9860,193,38,110,148
9861,9861,296,57,77,134
9862,9862,375,57,56,113
9863,9863,155,39,117,156
9864,9864,319,49,113,162
9865,9865,64,39,83,122
9866,9866,124,44,65,109
9867,9867,425,53,70,123
9868,9868,196,18,99,117
9869,9869,340,17,80,97
9870,9870,208,46,27,73
9871,9871,55,23,94,117
9872,9872,120,34,68,102
9873,9873,37,33,52,85
9874,9874,168,50,31,81
9875,9875,473,30,113,143
9876,9876,341,47,82,129
9877,9877,137,30,109,139
9878,9878,283,44,71,115
9879,9879,366,50,60,110
9880,9880,64,36,16,52
9881,9881,91,50,112,162
9882,9882,69,25,70,95
9883,9883,89,35,117,152
9884,9884,109,17,91,108
9885,9885,299,27,89,116
9886,9886,79,51,57,108
9887,9887,68,59,110,169
9888,9888,193,18,114,132
9889,9889,232,33,44,77
9890,9890,180,37,39,76
9891,9891,234,53,57,110
9892,9892,7,23,93,116
9893,9893,105,19,59,78
9894,9894,100,60,103,163
9895,9895,183,54,37,91
9896,9896,135,46,58,104
9897,9897,97,25,33,58
9898,9898,233,43,52,95
9899,9899,344,55,28,83
9900,9900,90,58,70,128
9901,9901,251,11,105,116
9902,9902,435,37,83,120
9903,9903,257,45,31,76
9904,9904,309,19,54,73
9905,9905,192,29,64,93
9906,9906,387,36,41,77
9907,9907,201,20,59,79
9908,9908,366,54,96,150
9909,9909,382,51,25,76
9910,9910,168,49,106,155
9911,9911,177,40,116,156
9912,9912,274,33,87,120
9913,9913,288,16,114,130
9914,9914,211,52,92,144
9915,9915,349,43,100,143
9916,9916,349,57,94,151
9917,9917,203,24,36,60
9918,9918,122,52,55,107
9919,9919,163,24,50,74
9920,9920,60,53,98,151
9921,9921,172,24,112,136
9922,9922,429,17,37,54
9923,9923,280,17,47,64
9924,9924,30,50,113,163
9925,9925,59,49,16,65
9926,9926,18,46,77,123
9927,9927,95,46,15,61
9928,9928,291,10,75,85
9929,9929,428,56,108,164
9930,9930,119,16,52,68
9931,9931,9,59,57,116
9932,9932,74,24,19,43
9933,9933,208,23,34,57
9934,9934,315,60,54,114
9935,9935,35,13,118,131
9936,9936,250,10,61,71
9937,9937,297,20,53,73
9938,9938,291,46,71,117
9939,9939,254,14,22,36
9940,9940,188,29,113,142
9941,9941,385,41,35,76
9942,9942,130,22,79,101
9943,9943,314,49,77,126
9944,9944,67,35,119,154
9945,9945,59,34,82,116
9946,9946,103,20,22,42
9947,9947,356,14,118,132
9948,9948,49,58,86,144
9949,9949,29,23,69,92
9950,9950,371,49,100,149
9951,9951,471,28,48,76
9952,9952,200,47,26,73
9953,9953,181,12,54,66
9954,9954,419,52,98,150
9955,9955,159,27,28,55
9956,9956,222,29,50,79
9957,9957,397,37,15,52
9958,9958,254,34,56,90
9959,9959,145,23,40,63
9960,9960,420,31,71,102
9961,9961,217,10,49,59
9962,9962,230,50,81,131
9963,9963,418,60,87,147
9964,9964,475,15,84,99
9965,9965,176,56,29,85
9966,9966,415,54,95,149
9967,9967,178,23,30,53
9968,9968,446,43,79,122
9969,9969,365,55,109,164
9970,9970,118,18,24,42
9971,9971,3,43,114,157
9972,9972,150,41,16,57
9973,9973,450,28,56,84
9974,9974,325,37,103,140
9975,9975,432,55,111,166
9976,9976,334,26,99,125
9977,9977,161,39,84,123
9978,9978,20,51,97,148
9979,9979,348,34,117,151
9980,9980,356,27,27,54
9981,9981,131,50,33,83
9982,9982,350,33,57,90
9983,9983,21,58,85,143
9984,9984,200,57,109,166
9985,9985,4,36,83,119
9986,9986,434,34,20,54
9987,9987,378,45,110,155
9988,9988,241,53,68,121
9989,9989,1,30,78,108
9990,9990,330,53,66,119
9991,9991,55,34,97,131
9992,9992,346,36,102,138
9993,9993,274,11,95,106
9994,9994,94,11,50,61
9995,9995,237,52,27,79
9996,9996,129,41,102,143
9997,9997,273,30,56,86
9998,9998,280,43,102,145
9999,9999,375,43,90,133
10000,10000,235,54,98,152
